//MAP CONVERTED BY dmm2tgm.py THIS HEADER COMMENT PREVENTS RECONVERSION, DO NOT REMOVE
"c" = (
/turf/closed/mineral/random/volcanic,
/area/ruin/space/has_grav/powered)
"d" = (
/obj/effect/turf_decal/stripes/line{
	dir = 6
	},
/turf/open/floor/plasteel/rockvault,
/area/ruin/space/has_grav/powered)
"e" = (
/obj/effect/turf_decal/stripes/line{
	dir = 4
	},
/turf/open/floor/circuit/green/anim,
/area/ruin/space/has_grav/powered)
"f" = (
/obj/effect/turf_decal/stripes/corner{
	dir = 8
	},
/turf/open/floor/plasteel/rockvault,
/area/ruin/space/has_grav/powered)
"h" = (
/obj/effect/turf_decal/stripes/corner{
	dir = 4
	},
/turf/open/floor/plasteel/rockvault,
/area/ruin/space/has_grav/powered)
"i" = (
/obj/effect/turf_decal/stripes/line{
	dir = 10
	},
/turf/open/floor/plasteel/rockvault,
/area/ruin/space/has_grav/powered)
"j" = (
/turf/open/floor/plasteel/rockvault,
/area/ruin/space/has_grav/powered)
"k" = (
/obj/effect/turf_decal/stripes/corner{
	dir = 1
	},
/turf/open/floor/plasteel/rockvault,
/area/ruin/space/has_grav/powered)
"l" = (
/mob/living/simple_animal/hostile/megafauna/rogueprocess,
/turf/open/floor/mech_bay_recharge_floor,
/area/ruin/space/has_grav/powered)
"p" = (
/obj/effect/turf_decal/stripes/corner{
	dir = 8
	},
/turf/open/floor/circuit/green/anim,
/area/ruin/space/has_grav/powered)
"q" = (
/obj/effect/turf_decal/caution/stand_clear/red{
	dir = 1
	},
/obj/machinery/door/firedoor/closed,
/turf/open/floor/plasteel/rockvault,
/area/ruin/space/has_grav/powered)
"s" = (
/obj/effect/turf_decal/stripes/line,
/turf/open/floor/plasteel/rockvault,
/area/ruin/space/has_grav/powered)
"t" = (
/obj/effect/turf_decal/stripes/corner,
/turf/open/floor/circuit/green/anim,
/area/ruin/space/has_grav/powered)
"u" = (
/obj/effect/turf_decal/stripes/line{
	dir = 8
	},
/turf/open/floor/plasteel/rockvault,
/area/ruin/space/has_grav/powered)
"x" = (
/obj/effect/turf_decal/stripes/line,
/turf/open/floor/circuit/green/anim,
/area/ruin/space/has_grav/powered)
"C" = (
/obj/effect/turf_decal/stripes/line{
	dir = 5
	},
/turf/open/floor/plasteel/rockvault,
/area/ruin/space/has_grav/powered)
"E" = (
/obj/effect/turf_decal/stripes/line{
	dir = 1
	},
/turf/open/floor/plasteel/rockvault,
/area/ruin/space/has_grav/powered)
"H" = (
/obj/effect/turf_decal/stripes/line{
	dir = 1
	},
/turf/open/floor/circuit/green/anim,
/area/ruin/space/has_grav/powered)
"I" = (
/obj/effect/turf_decal/caution/stand_clear/red{
	dir = 4
	},
/obj/machinery/door/firedoor/closed,
/turf/open/floor/plasteel/rockvault,
/area/ruin/space/has_grav/powered)
"M" = (
/obj/effect/turf_decal/caution/stand_clear/red{
	dir = 8
	},
/obj/machinery/door/firedoor/closed,
/turf/open/floor/plasteel/rockvault,
/area/ruin/space/has_grav/powered)
"N" = (
/obj/effect/turf_decal/stripes/corner,
/turf/open/floor/plasteel/rockvault,
/area/ruin/space/has_grav/powered)
"O" = (
/obj/effect/turf_decal/stripes/line{
	dir = 4
	},
/turf/open/floor/plasteel/rockvault,
/area/ruin/space/has_grav/powered)
"P" = (
/obj/effect/turf_decal/stripes/line{
	dir = 8
	},
/turf/open/floor/circuit/green/anim,
/area/ruin/space/has_grav/powered)
"R" = (
/obj/effect/turf_decal/stripes/corner{
	dir = 4
	},
/turf/open/floor/circuit/green/anim,
/area/ruin/space/has_grav/powered)
"S" = (
/obj/effect/turf_decal/stripes/corner{
	dir = 1
	},
/turf/open/floor/circuit/green/anim,
/area/ruin/space/has_grav/powered)
"T" = (
/turf/open/lava/smooth/lava_land_surface,
/area/ruin/space/has_grav/powered)
"U" = (
/obj/effect/turf_decal/stripes/line{
	dir = 9
	},
/turf/open/floor/plasteel/rockvault,
/area/ruin/space/has_grav/powered)
"W" = (
/obj/effect/turf_decal/caution/stand_clear/red,
/obj/machinery/door/firedoor/closed,
/turf/open/floor/plasteel/rockvault,
/area/ruin/space/has_grav/powered)
"X" = (
/turf/open/floor/circuit/green/anim,
/area/ruin/space/has_grav/powered)

(1,1,1) = {"
c
c
c
c
c
c
c
c
c
c
c
c
c
c
c
c
c
c
c
c
c
c
c
"}
(2,1,1) = {"
c
c
c
c
c
T
T
T
T
T
T
M
T
T
T
T
T
T
c
c
c
c
c
"}
(3,1,1) = {"
c
c
c
T
T
T
T
j
j
j
s
X
E
j
j
j
T
T
T
T
c
c
c
"}
(4,1,1) = {"
c
c
T
T
T
j
j
j
j
j
s
X
E
j
j
j
j
j
T
T
T
c
c
"}
(5,1,1) = {"
c
c
T
T
j
j
j
j
j
j
s
X
E
j
j
j
j
j
j
T
T
c
c
"}
(6,1,1) = {"
c
T
T
j
j
j
j
j
j
j
s
X
E
j
j
j
j
j
j
j
T
T
c
"}
(7,1,1) = {"
c
T
T
j
j
j
j
j
j
j
s
X
E
j
j
j
j
j
j
j
T
T
c
"}
(8,1,1) = {"
c
T
j
j
j
j
j
j
j
j
s
X
E
j
j
j
j
j
j
j
j
T
c
"}
(9,1,1) = {"
c
T
j
j
j
j
j
j
j
j
s
X
E
j
j
j
j
j
j
j
j
T
c
"}
(10,1,1) = {"
c
T
j
j
j
j
j
j
j
N
d
X
C
f
j
j
j
j
j
j
j
T
c
"}
(11,1,1) = {"
c
T
O
O
O
O
O
O
O
d
t
e
p
C
O
O
O
O
O
O
O
T
c
"}
(12,1,1) = {"
c
q
X
X
X
X
X
X
X
X
x
l
H
X
X
X
X
X
X
X
X
W
c
"}
(13,1,1) = {"
c
T
u
u
u
u
u
u
u
i
S
P
R
U
u
u
u
u
u
u
u
T
c
"}
(14,1,1) = {"
c
T
j
j
j
j
j
j
j
k
i
X
U
h
j
j
j
j
j
j
j
T
c
"}
(15,1,1) = {"
c
T
j
j
j
j
j
j
j
j
s
X
E
j
j
j
j
j
j
j
j
T
c
"}
(16,1,1) = {"
c
T
j
j
j
j
j
j
j
j
s
X
E
j
j
j
j
j
j
j
j
T
c
"}
(17,1,1) = {"
c
T
T
j
j
j
j
j
j
j
s
X
E
j
j
j
j
j
j
j
T
T
c
"}
(18,1,1) = {"
c
T
T
j
j
j
j
j
j
j
s
X
E
j
j
j
j
j
j
j
T
T
c
"}
(19,1,1) = {"
c
c
T
T
j
j
j
j
j
j
s
X
E
j
j
j
j
j
j
T
T
c
c
"}
(20,1,1) = {"
c
c
T
T
T
j
j
j
j
j
s
X
E
j
j
j
j
j
T
T
T
c
c
"}
(21,1,1) = {"
c
c
c
T
T
T
T
j
j
j
s
X
E
j
j
j
T
T
T
T
c
c
c
"}
(22,1,1) = {"
c
c
c
c
c
T
T
T
T
T
T
I
T
T
T
T
T
T
c
c
c
c
c
"}
(23,1,1) = {"
c
c
c
c
c
c
c
c
c
c
c
c
c
c
c
c
c
c
c
c
c
c
c
"}
