//MAP CONVERTED BY dmm2tgm.py THIS HEADER COMMENT PREVENTS RECONVERSION, DO NOT REMOVE
"a" = (
/turf/closed/indestructible/riveted/hierophant/coolbird,
/area/space)
"r" = (
/mob/living/simple_animal/hostile/megafauna/hierophant/coolbird{
	pixel_x = -14
	},
/turf/open/indestructible/hierophant/coolbird/two,
/area/space)
"v" = (
/turf/open/indestructible/hierophant/coolbird/two,
/area/space)
"R" = (
/turf/open/indestructible/hierophant/coolbird,
/area/space)

(1,1,1) = {"
a
a
a
R
R
R
a
a
R
R
R
R
R
R
R
a
a
R
R
R
a
a
a
"}
(2,1,1) = {"
a
R
R
R
R
R
R
R
R
R
R
R
R
R
R
R
R
R
R
R
R
R
a
"}
(3,1,1) = {"
a
R
R
R
R
R
R
R
R
R
R
R
R
R
R
R
R
R
R
R
R
R
a
"}
(4,1,1) = {"
R
R
R
R
R
R
R
R
R
R
a
a
a
R
R
R
R
R
R
R
R
R
R
"}
(5,1,1) = {"
R
R
R
R
R
R
R
R
R
R
R
R
R
R
R
R
R
R
R
R
R
R
R
"}
(6,1,1) = {"
R
R
R
R
R
R
R
R
R
R
R
R
R
R
R
R
R
R
R
R
R
R
R
"}
(7,1,1) = {"
a
R
R
R
R
R
a
a
R
R
R
R
R
R
R
a
a
R
R
R
R
R
a
"}
(8,1,1) = {"
a
R
R
R
R
R
a
a
R
R
R
a
R
R
R
a
a
R
R
R
R
R
a
"}
(9,1,1) = {"
R
R
R
R
R
R
R
R
v
v
v
v
v
v
v
R
R
R
R
R
R
R
R
"}
(10,1,1) = {"
R
R
R
R
R
R
R
R
v
v
v
v
v
v
v
R
R
R
R
R
R
R
R
"}
(11,1,1) = {"
R
R
R
a
R
R
R
R
v
v
v
v
v
v
v
R
R
R
R
a
R
R
R
"}
(12,1,1) = {"
R
R
R
a
R
R
R
a
v
v
v
r
v
v
v
a
R
R
R
a
R
R
R
"}
(13,1,1) = {"
R
R
R
a
R
R
R
R
v
v
v
v
v
v
v
R
R
R
R
a
R
R
R
"}
(14,1,1) = {"
R
R
R
R
R
R
R
R
v
v
v
v
v
v
v
R
R
R
R
R
R
R
R
"}
(15,1,1) = {"
R
R
R
R
R
R
R
R
v
v
v
v
v
v
v
R
R
R
R
R
R
R
R
"}
(16,1,1) = {"
a
R
R
R
R
R
a
a
R
R
R
a
R
R
R
a
a
R
R
R
R
R
a
"}
(17,1,1) = {"
a
R
R
R
R
R
a
a
R
R
R
R
R
R
R
a
a
R
R
R
R
R
a
"}
(18,1,1) = {"
R
R
R
R
R
R
R
R
R
R
R
R
R
R
R
R
R
R
R
R
R
R
R
"}
(19,1,1) = {"
R
R
R
R
R
R
R
R
R
R
R
R
R
R
R
R
R
R
R
R
R
R
R
"}
(20,1,1) = {"
R
R
R
R
R
R
R
R
R
R
R
R
R
R
R
R
R
R
R
R
R
R
R
"}
(21,1,1) = {"
a
R
R
R
R
R
R
R
R
R
a
a
a
R
R
R
R
R
R
R
R
R
a
"}
(22,1,1) = {"
a
R
R
R
R
R
R
R
R
R
R
R
R
R
R
R
R
R
R
R
R
R
a
"}
(23,1,1) = {"
a
a
R
R
R
R
a
a
R
R
R
R
R
R
R
a
a
R
R
R
a
a
a
"}
