//MAP CONVERTED BY dmm2tgm.py THIS HEADER COMMENT PREVENTS RECONVERSION, DO NOT REMOVE
"aj" = (
/obj/item/wallframe/airalarm,
/turf/open/floor/plasteel/airless,
/area/lavaland/surface/outdoors)
"bp" = (
/obj/structure/cable{
	icon_state = "1-8"
	},
/turf/open/floor/plating/asteroid/basalt/lava_land_surface,
/area/lavaland/surface/outdoors)
"bv" = (
/obj/machinery/atmospherics/pipe/simple/cyan/visible/layer1{
	dir = 4
	},
/turf/open/floor/plating/asteroid/basalt/lava_land_surface,
/area/lavaland/surface/outdoors)
"ch" = (
/turf/closed/wall,
/area/lavaland/surface/outdoors)
"cj" = (
/obj/structure/cable{
	icon_state = "4-8"
	},
/obj/machinery/door/airlock/atmos/glass,
/turf/open/floor/plasteel/airless,
/area/lavaland/surface/outdoors)
"cZ" = (
/obj/item/tank/internals/oxygen,
/obj/item/clothing/mask/breath,
/turf/open/floor/plating/asteroid/basalt/lava_land_surface,
/area/lavaland/surface/outdoors)
"dw" = (
/obj/item/pickaxe,
/obj/item/mining_scanner,
/turf/open/floor/plating/asteroid/basalt/lava_land_surface,
/area/lavaland/surface/outdoors)
"dA" = (
/obj/machinery/power/smes,
/obj/structure/cable{
	icon_state = "0-4"
	},
/turf/open/floor/plating/asteroid/basalt/lava_land_surface,
/area/lavaland/surface/outdoors)
"dV" = (
/obj/item/wallframe/apc,
/obj/structure/cable{
	icon_state = "0-8"
	},
/turf/open/floor/plating/asteroid/basalt/lava_land_surface,
/area/lavaland/surface/outdoors)
"eP" = (
/obj/item/stack/cable_coil/cut,
/turf/open/floor/plasteel/airless,
/area/lavaland/surface/outdoors)
"fi" = (
/obj/structure/cable{
	icon_state = "1-2"
	},
/obj/item/stock_parts/cell,
/turf/open/floor/plating/asteroid/basalt/lava_land_surface,
/area/lavaland/surface/outdoors)
"gd" = (
/obj/structure/frame/machine,
/turf/open/floor/plating/asteroid/basalt/lava_land_surface,
/area/lavaland/surface/outdoors)
"ha" = (
/turf/open/floor/plating/asteroid/basalt/lava_land_surface,
/area/lavaland/surface/outdoors)
"ig" = (
/obj/structure/cable{
	icon_state = "1-8"
	},
/obj/structure/cable{
	icon_state = "2-8"
	},
/turf/open/floor/plasteel/airless,
/area/lavaland/surface/outdoors)
"ir" = (
/obj/item/stock_parts/cell,
/turf/open/floor/plasteel/airless,
/area/lavaland/surface/outdoors)
"jO" = (
/obj/structure/window/reinforced/spawner/west,
/obj/structure/window/reinforced/spawner,
/obj/effect/mapping_helpers/no_lava,
/turf/open/floor/plating/asteroid/basalt/lava_land_surface,
/area/lavaland/surface/outdoors)
"kA" = (
/obj/machinery/computer/rdconsole/production{
	dir = 4
	},
/obj/item/stack/sheet/mineral/plasma,
/turf/open/floor/plating/asteroid/basalt/lava_land_surface,
/area/lavaland/surface/outdoors)
"lC" = (
/obj/item/stock_parts/cell,
/turf/open/floor/plating/asteroid/basalt/lava_land_surface,
/area/lavaland/surface/outdoors)
"mp" = (
/obj/structure/cable{
	icon_state = "2-8"
	},
/turf/open/floor/plasteel/airless,
/area/lavaland/surface/outdoors)
"nu" = (
/obj/structure/cable{
	icon_state = "1-2"
	},
/obj/structure/cable{
	icon_state = "2-4"
	},
/turf/open/floor/plating/asteroid/basalt/lava_land_surface,
/area/lavaland/surface/outdoors)
"nz" = (
/obj/structure/grille,
/turf/open/floor/plasteel/airless,
/area/lavaland/surface/outdoors)
"oN" = (
/obj/structure/cable{
	icon_state = "1-2"
	},
/turf/open/floor/plasteel/airless,
/area/lavaland/surface/outdoors)
"pE" = (
/obj/item/vending_refill/kink,
/obj/effect/decal/cleanable/semen,
/turf/open/floor/plating/asteroid/basalt/lava_land_surface,
/area/lavaland/surface/outdoors)
"rp" = (
/obj/machinery/door/airlock/research/glass,
/obj/structure/cable{
	icon_state = "1-2"
	},
/turf/open/floor/plating/asteroid/basalt/lava_land_surface,
/area/lavaland/surface/outdoors)
"rR" = (
/obj/item/storage/toolbox/mechanical,
/turf/open/floor/plating/asteroid/basalt/lava_land_surface,
/area/lavaland/surface/outdoors)
"ue" = (
/obj/machinery/ore_silo,
/obj/item/stack/sheet/mineral/diamond{
	amount = 5
	},
/turf/open/floor/plasteel/airless,
/area/lavaland/surface/outdoors)
"uP" = (
/obj/structure/grille,
/obj/structure/window/reinforced/fulltile,
/turf/open/floor/plasteel/airless,
/area/lavaland/surface/outdoors)
"wd" = (
/obj/structure/frame/machine,
/turf/open/floor/plasteel/airless,
/area/lavaland/surface/outdoors)
"wj" = (
/obj/structure/cable{
	icon_state = "0-8"
	},
/obj/structure/cable{
	icon_state = "2-4"
	},
/turf/open/floor/plating/asteroid/basalt/lava_land_surface,
/area/lavaland/surface/outdoors)
"wk" = (
/obj/item/stack/sheet/metal/ten,
/turf/open/floor/plasteel/airless,
/area/lavaland/surface/outdoors)
"wF" = (
/obj/item/circuitboard/machine/mining_equipment_vendor/golem,
/turf/open/floor/plating/asteroid/basalt/lava_land_surface,
/area/lavaland/surface/outdoors)
"yv" = (
/obj/structure/window/reinforced/spawner,
/obj/machinery/atmospherics/components/unary/outlet_injector/layer1,
/obj/effect/mapping_helpers/no_lava,
/turf/open/floor/plating/asteroid/basalt/lava_land_surface,
/area/lavaland/surface/outdoors)
"zu" = (
/obj/structure/cable,
/obj/item/stack/sheet/metal/ten,
/turf/open/floor/plasteel/airless,
/area/lavaland/surface/outdoors)
"AW" = (
/obj/structure/window/reinforced/spawner,
/obj/structure/window/reinforced/spawner/east,
/obj/machinery/atmospherics/components/unary/vent_scrubber/layer3,
/obj/effect/mapping_helpers/no_lava,
/turf/open/floor/plating/asteroid/basalt/lava_land_surface,
/area/lavaland/surface/outdoors)
"Br" = (
/obj/item/stack/cable_coil/cut,
/turf/open/floor/plating/asteroid/basalt/lava_land_surface,
/area/lavaland/surface/outdoors)
"BX" = (
/obj/item/wallframe/airalarm,
/turf/open/floor/plating/asteroid/basalt/lava_land_surface,
/area/lavaland/surface/outdoors)
"Cj" = (
/obj/machinery/mineral/ore_redemption,
/turf/open/floor/plating/asteroid/basalt/lava_land_surface,
/area/lavaland/surface/outdoors)
"CL" = (
/obj/structure/cable,
/obj/effect/mapping_helpers/no_lava,
/turf/open/floor/plating/asteroid/basalt/lava_land_surface,
/area/lavaland/surface/outdoors)
"CV" = (
/obj/machinery/door/airlock/external/glass,
/turf/open/floor/plasteel/airless,
/area/lavaland/surface/outdoors)
"CX" = (
/obj/effect/mob_spawn/human/wandering_hermit,
/turf/open/floor/plating/asteroid/basalt/lava_land_surface,
/area/lavaland/surface/outdoors)
"Dr" = (
/obj/structure/girder,
/obj/effect/mapping_helpers/no_lava,
/turf/open/floor/plating/asteroid/basalt/lava_land_surface,
/area/lavaland/surface/outdoors)
"Dz" = (
/obj/effect/mapping_helpers/no_lava,
/obj/effect/mapping_helpers/no_lava,
/turf/open/floor/plating/asteroid/basalt/lava_land_surface,
/area/lavaland/surface/outdoors)
"ER" = (
/obj/structure/window/reinforced/spawner/east,
/obj/structure/window/reinforced/spawner,
/obj/machinery/atmospherics/components/unary/vent_scrubber/layer1{
	anchored = 0;
	dir = 8
	},
/obj/effect/mapping_helpers/no_lava,
/obj/item/pipe_dispenser,
/turf/open/floor/plating/asteroid/basalt/lava_land_surface,
/area/lavaland/surface/outdoors)
"FZ" = (
/obj/item/stack/cable_coil/red,
/turf/open/floor/plasteel/airless,
/area/lavaland/surface/outdoors)
"GU" = (
/obj/structure/cable,
/turf/open/floor/plating/asteroid/basalt/lava_land_surface,
/area/lavaland/surface/outdoors)
"HK" = (
/obj/structure/frame/machine,
/obj/item/circuitboard/machine/autolathe,
/turf/open/floor/plating/asteroid/basalt/lava_land_surface,
/area/lavaland/surface/outdoors)
"II" = (
/obj/structure/cable{
	icon_state = "1-4"
	},
/turf/open/floor/plating/asteroid/basalt/lava_land_surface,
/area/lavaland/surface/outdoors)
"IK" = (
/obj/structure/cable{
	icon_state = "2-4"
	},
/turf/open/floor/plating/asteroid/basalt/lava_land_surface,
/area/lavaland/surface/outdoors)
"Jb" = (
/obj/machinery/atmospherics/pipe/simple/brown/visible/layer1{
	dir = 5
	},
/turf/open/floor/plating/asteroid/basalt/lava_land_surface,
/area/lavaland/surface/outdoors)
"Kl" = (
/obj/item/circuitboard/machine/pacman,
/obj/structure/cable{
	icon_state = "0-2"
	},
/obj/structure/frame/machine,
/obj/item/stock_parts/micro_laser/high,
/obj/item/stock_parts/matter_bin/adv,
/turf/open/floor/plasteel/airless,
/area/lavaland/surface/outdoors)
"Ku" = (
/obj/item/wallframe/apc,
/obj/structure/frame/machine,
/turf/open/floor/plasteel/airless,
/area/lavaland/surface/outdoors)
"KS" = (
/obj/structure/cable{
	icon_state = "1-2"
	},
/turf/open/floor/plating/asteroid/basalt/lava_land_surface,
/area/lavaland/surface/outdoors)
"Le" = (
/obj/structure/cable{
	icon_state = "4-8"
	},
/obj/item/crowbar,
/turf/open/floor/plasteel/airless,
/area/lavaland/surface/outdoors)
"Nq" = (
/turf/open/floor/plasteel/airless,
/area/lavaland/surface/outdoors)
"Pm" = (
/obj/structure/girder,
/turf/open/floor/plating/asteroid/basalt/lava_land_surface,
/area/lavaland/surface/outdoors)
"Qn" = (
/obj/effect/mapping_helpers/no_lava,
/turf/open/floor/plating/asteroid/basalt/lava_land_surface,
/area/lavaland/surface/outdoors)
"QN" = (
/obj/structure/cable{
	icon_state = "4-8"
	},
/turf/open/floor/plating/asteroid/basalt/lava_land_surface,
/area/lavaland/surface/outdoors)
"QQ" = (
/turf/closed/mineral/volcanic/lava_land_surface,
/area/lavaland/surface/outdoors)
"QR" = (
/obj/item/electronics/apc,
/obj/item/electronics/apc,
/obj/item/electronics/apc,
/obj/item/electronics/apc,
/obj/item/wallframe/apc,
/obj/item/wallframe/apc,
/obj/item/wallframe/apc,
/obj/item/electronics/airalarm,
/obj/item/electronics/airalarm,
/obj/item/electronics/airalarm,
/obj/item/electronics/airalarm,
/obj/item/electronics/airalarm,
/obj/structure/closet/crate,
/obj/item/circuitboard/machine/vendor,
/turf/open/floor/plasteel/airless,
/area/lavaland/surface/outdoors)
"SS" = (
/obj/machinery/atmospherics/pipe/simple/cyan/visible/layer1{
	dir = 9
	},
/turf/open/floor/plating/asteroid/basalt/lava_land_surface,
/area/lavaland/surface/outdoors)
"SU" = (
/obj/structure/cable{
	icon_state = "0-4"
	},
/obj/item/stack/cable_coil/cut,
/turf/open/floor/plating/asteroid/basalt/lava_land_surface,
/area/lavaland/surface/outdoors)
"Tu" = (
/obj/structure/cable,
/obj/item/stock_parts/capacitor/adv,
/turf/open/floor/plating/asteroid/basalt/lava_land_surface,
/area/lavaland/surface/outdoors)
"Tz" = (
/turf/template_noop,
/area/template_noop)
"UD" = (
/obj/structure/cable{
	icon_state = "0-8"
	},
/turf/open/floor/plating/asteroid/basalt/lava_land_surface,
/area/lavaland/surface/outdoors)
"UE" = (
/obj/machinery/door/airlock/glass,
/turf/open/floor/plasteel/airless,
/area/lavaland/surface/outdoors)
"UK" = (
/obj/machinery/door/airlock/public/glass,
/obj/structure/cable{
	icon_state = "1-2"
	},
/turf/open/floor/plasteel/airless,
/area/lavaland/surface/outdoors)
"VT" = (
/obj/item/card/id/mining,
/turf/open/floor/plating/asteroid/basalt/lava_land_surface,
/area/lavaland/surface/outdoors)
"We" = (
/obj/machinery/atmospherics/components/trinary/mixer/flipped/layer1{
	dir = 8
	},
/obj/machinery/atmospherics/pipe/simple/brown/visible/layer1,
/obj/machinery/atmospherics/pipe/simple/cyan/visible/layer1{
	dir = 4
	},
/turf/open/floor/plating/asteroid/basalt/lava_land_surface,
/area/lavaland/surface/outdoors)
"Yl" = (
/obj/effect/decal/cleanable/semendrip,
/turf/open/floor/plasteel/airless,
/area/lavaland/surface/outdoors)
"Yt" = (
/obj/structure/cable{
	icon_state = "0-4"
	},
/turf/open/floor/plating/asteroid/basalt/lava_land_surface,
/area/lavaland/surface/outdoors)
"ZP" = (
/obj/structure/cable{
	icon_state = "4-8"
	},
/turf/open/floor/plasteel/airless,
/area/lavaland/surface/outdoors)

(1,1,1) = {"
Tz
Tz
Tz
Tz
Tz
Tz
Tz
Tz
Tz
Tz
Tz
Tz
Tz
Tz
Tz
Tz
"}
(2,1,1) = {"
Tz
Tz
QQ
QQ
QQ
QQ
QQ
QQ
QQ
Tz
Tz
Tz
Tz
Tz
Tz
Tz
"}
(3,1,1) = {"
Tz
QQ
QQ
Pm
Pm
ch
ch
ch
Qn
QQ
QQ
QQ
Tz
Tz
Tz
Tz
"}
(4,1,1) = {"
QQ
QQ
ha
Pm
ha
II
QR
Pm
Qn
Qn
Qn
QQ
QQ
Tz
Tz
Tz
"}
(5,1,1) = {"
QQ
QQ
Qn
ch
BX
ZP
BX
Pm
Qn
Qn
Qn
ha
QQ
QQ
Tz
Tz
"}
(6,1,1) = {"
QQ
Qn
Qn
ch
ir
QN
CX
Pm
Qn
Qn
Qn
ha
ha
QQ
QQ
Tz
"}
(7,1,1) = {"
QQ
Qn
Qn
ch
Nq
Le
ha
ch
Qn
Qn
Qn
Qn
ha
QQ
QQ
Tz
"}
(8,1,1) = {"
QQ
Qn
Qn
UE
ha
wj
oN
UK
CL
Qn
Qn
Qn
Qn
ha
QQ
QQ
"}
(9,1,1) = {"
ha
Qn
Dz
ch
Nq
SU
wk
ch
Qn
Qn
Qn
Qn
Dz
Qn
QQ
QQ
"}
(10,1,1) = {"
ha
ha
Qn
Pm
Pm
cj
ch
ch
ch
ch
ch
Pm
Qn
Qn
ha
QQ
"}
(11,1,1) = {"
QQ
ha
Qn
Pm
cZ
QN
Nq
ch
Kl
zu
dA
ch
Qn
Qn
Qn
QQ
"}
(12,1,1) = {"
QQ
ha
Qn
ch
ha
mp
nu
KS
fi
Tu
dV
ch
Qn
Qn
Qn
Qn
"}
(13,1,1) = {"
ha
Qn
Qn
uP
jO
Jb
UD
ch
ch
Pm
ch
ch
ch
ch
ch
Qn
"}
(14,1,1) = {"
QQ
Qn
Qn
nz
ER
We
ha
ch
gd
kA
FZ
ch
Nq
ue
ch
Qn
"}
(15,1,1) = {"
QQ
Qn
Qn
ch
aj
bv
Yt
Pm
rR
VT
pE
Pm
Br
Nq
Pm
Qn
"}
(16,1,1) = {"
QQ
Qn
Dz
uP
yv
SS
QN
ch
ch
Yl
ch
Pm
lC
Nq
Pm
Qn
"}
(17,1,1) = {"
QQ
Qn
Qn
uP
AW
IK
ig
rp
GU
Br
HK
gd
ha
ha
ch
Qn
"}
(18,1,1) = {"
QQ
QQ
Qn
ch
ha
Yt
Nq
Pm
Nq
Nq
Nq
Nq
ha
Ku
ch
Qn
"}
(19,1,1) = {"
QQ
QQ
QQ
ch
wF
ZP
Nq
ch
aj
wd
Nq
ha
Br
eP
ch
Qn
"}
(20,1,1) = {"
Tz
QQ
QQ
ch
ch
ZP
ch
ch
ch
ch
ch
Pm
Pm
ch
ch
Qn
"}
(21,1,1) = {"
QQ
QQ
QQ
ch
dw
bp
ha
Qn
Qn
Qn
Qn
Qn
Qn
Qn
Qn
Qn
"}
(22,1,1) = {"
QQ
QQ
ha
ha
Cj
ha
Dr
Qn
Qn
Qn
Qn
QQ
QQ
Qn
Qn
QQ
"}
(23,1,1) = {"
QQ
ha
Qn
Pm
ha
ha
Dr
Qn
Qn
Qn
Dz
Dz
Dz
Qn
QQ
QQ
"}
(24,1,1) = {"
QQ
ha
Qn
Pm
ha
CV
Qn
Qn
Qn
QQ
Qn
ha
ha
QQ
QQ
QQ
"}
(25,1,1) = {"
QQ
ha
Qn
Dz
Qn
Qn
Dz
Qn
Qn
Qn
ha
QQ
QQ
QQ
QQ
QQ
"}
(26,1,1) = {"
ha
ha
ha
Qn
Qn
Qn
Dz
Qn
Qn
Qn
QQ
QQ
QQ
QQ
QQ
QQ
"}
