//MAP CONVERTED BY dmm2tgm.py THIS HEADER COMMENT PREVENTS RECONVERSION, DO NOT REMOVE
"aa" = (
/obj/structure/cable/yellow{
	icon_state = "4-8"
	},
/obj/machinery/atmospherics/pipe/simple/supply/hidden{
	dir = 4
	},
/obj/effect/turf_decal/stripes/line{
	dir = 1
	},
/obj/machinery/camera{
	c_tag = "Engineering Supermatter Fore";
	network = list("ss13","engine");
	pixel_x = 23
	},
/obj/machinery/light{
	dir = 1
	},
/turf/open/floor/plating,
/area/engineering/main)
"ab" = (
/obj/effect/spawner/structure/window/plasma/reinforced,
/obj/machinery/atmospherics/pipe/simple/supply/hidden{
	dir = 6
	},
/turf/open/floor/plating,
/area/engineering/main)
"ac" = (
/obj/effect/turf_decal/caution/stand_clear,
/turf/open/floor/plating,
/area/engineering/main)
"ad" = (
/obj/machinery/atmospherics/pipe/simple/scrubbers/hidden,
/obj/effect/turf_decal/stripes/line{
	dir = 8
	},
/obj/machinery/light{
	dir = 8
	},
/turf/open/floor/plating,
/area/engineering/main)
"af" = (
/obj/structure/cable{
	icon_state = "1-2"
	},
/obj/structure/cable{
	icon_state = "1-10"
	},
/turf/open/floor/plating,
/area/engineering/main)
"ag" = (
/obj/structure/rack,
/obj/item/pipe_dispenser{
	pixel_y = 5
	},
/obj/item/pipe_dispenser,
/obj/item/pipe_dispenser{
	pixel_y = -5
	},
/turf/open/floor/plasteel/dark,
/area/engineering/main)
"ah" = (
/obj/structure/rack,
/obj/item/tank/internals/emergency_oxygen/double{
	pixel_x = 5
	},
/obj/item/tank/internals/emergency_oxygen/double,
/obj/item/stack/cable_coil/yellow,
/obj/item/flashlight{
	pixel_x = 1;
	pixel_y = 5
	},
/obj/item/flashlight,
/obj/machinery/atmospherics/pipe/simple/supply/hidden,
/turf/open/floor/plasteel/dark,
/area/engineering/main)
"at" = (
/obj/structure/closet/crate/bin,
/obj/effect/turf_decal/stripes/line{
	dir = 10
	},
/obj/item/cartridge/atmos,
/turf/open/floor/plating,
/area/engineering/main)
"av" = (
/obj/effect/spawner/structure/window/plasma/reinforced,
/obj/machinery/atmospherics/pipe/manifold/supply/hidden{
	dir = 1
	},
/turf/open/floor/plating,
/area/engineering/main)
"aA" = (
/obj/machinery/atmospherics/pipe/simple/scrubbers/hidden{
	dir = 6
	},
/turf/closed/wall/r_wall,
/area/engineering/main)
"aV" = (
/obj/structure/fluff/railing/corner{
	dir = 4
	},
/turf/open/floor/plating,
/area/engineering/main)
"aX" = (
/obj/structure/fluff/railing/corner{
	dir = 1
	},
/turf/open/floor/plating,
/area/engineering/main)
"bH" = (
/obj/structure/cable{
	icon_state = "1-2"
	},
/obj/effect/turf_decal/stripes/line,
/obj/machinery/atmospherics/components/binary/valve{
	dir = 4;
	name = "Output to Waste"
	},
/turf/open/floor/plating,
/area/engineering/main)
"bI" = (
/obj/structure/closet/crate/large,
/obj/item/stack/sheet/plasmarglass{
	amount = 50
	},
/obj/item/stack/sheet/plasmarglass{
	amount = 50
	},
/obj/item/stack/sheet/mineral/plasma{
	amount = 50
	},
/obj/effect/turf_decal/box/corners{
	dir = 1
	},
/turf/open/floor/plasteel/dark,
/area/engineering/main)
"bT" = (
/obj/machinery/atmospherics/pipe/simple/supply/hidden{
	dir = 4
	},
/obj/effect/turf_decal/stripes/line{
	dir = 5
	},
/obj/machinery/light{
	dir = 1
	},
/turf/open/floor/plating,
/area/engineering/main)
"ck" = (
/obj/machinery/atmospherics/pipe/simple/scrubbers/hidden{
	dir = 4
	},
/turf/closed/wall/r_wall,
/area/engineering/main)
"cp" = (
/obj/machinery/atmospherics/components/unary/vent_scrubber/on{
	dir = 1
	},
/turf/open/floor/plasteel/dark,
/area/engineering/main)
"cP" = (
/obj/structure/table,
/obj/item/clothing/gloves/color/yellow,
/obj/item/storage/toolbox/electrical{
	pixel_y = 5
	},
/turf/open/floor/plasteel,
/area/engineering/main)
"cS" = (
/obj/machinery/atmospherics/pipe/simple/scrubbers/hidden{
	dir = 4
	},
/obj/structure/sign/poster/official/safety_eye_protection,
/turf/closed/wall/r_wall,
/area/engineering/main)
"dl" = (
/obj/structure/cable{
	icon_state = "1-4"
	},
/turf/open/floor/plasteel,
/area/engineering/main)
"dw" = (
/obj/structure/lattice/catwalk,
/turf/open/space,
/area/space/nearstation)
"dD" = (
/obj/machinery/power/rad_collector,
/obj/machinery/atmospherics/pipe/simple/supply/hidden,
/turf/open/floor/plasteel/dark,
/area/engineering/main)
"ej" = (
/obj/effect/turf_decal/stripes/line,
/obj/machinery/atmospherics/pipe/simple/scrubbers/visible{
	dir = 4
	},
/obj/machinery/light,
/turf/open/floor/plating,
/area/engineering/main)
"ey" = (
/obj/machinery/atmospherics/pipe/simple/scrubbers/visible{
	dir = 4
	},
/obj/machinery/camera{
	c_tag = "Engineering Supermatter Aft";
	dir = 1;
	network = list("ss13","engine");
	pixel_x = 23
	},
/obj/effect/turf_decal/stripes/corner,
/obj/effect/turf_decal/stripes/corner{
	dir = 1
	},
/turf/open/floor/plating,
/area/engineering/main)
"ez" = (
/obj/structure/reflector/box{
	dir = 8
	},
/turf/open/floor/plasteel/dark,
/area/engineering/main)
"fj" = (
/obj/machinery/power/emitter{
	dir = 4
	},
/turf/open/floor/plasteel/dark,
/area/engineering/main)
"fq" = (
/obj/effect/spawner/structure/window/plasma/reinforced,
/obj/machinery/atmospherics/pipe/simple/scrubbers/visible{
	dir = 10
	},
/turf/open/floor/plating,
/area/engineering/main)
"fK" = (
/obj/machinery/firealarm{
	dir = 4;
	pixel_x = 24
	},
/obj/machinery/power/emitter{
	dir = 4
	},
/turf/open/floor/plasteel/dark,
/area/engineering/main)
"fW" = (
/obj/effect/turf_decal/stripes/line{
	dir = 8
	},
/turf/open/floor/plating,
/area/engineering/main)
"gf" = (
/obj/machinery/atmospherics/pipe/simple/scrubbers/hidden,
/turf/closed/wall/r_wall,
/area/engineering/main)
"gQ" = (
/obj/structure/closet/crate/large,
/obj/item/stack/sheet/plasteel/fifty,
/obj/item/stack/sheet/plasteel/fifty,
/obj/item/stack/sheet/plasteel/fifty,
/obj/effect/turf_decal/box/corners,
/turf/open/floor/plasteel/dark,
/area/engineering/main)
"hJ" = (
/obj/structure/cable/yellow{
	icon_state = "4-8"
	},
/obj/effect/turf_decal/stripes/line{
	dir = 9
	},
/obj/machinery/light{
	dir = 1
	},
/obj/machinery/atmospherics/pipe/manifold/supply/hidden{
	dir = 1
	},
/turf/open/floor/plating,
/area/engineering/main)
"in" = (
/obj/effect/turf_decal/stripes/line{
	dir = 5
	},
/obj/machinery/atmospherics/pipe/simple/scrubbers/hidden{
	dir = 9
	},
/turf/open/floor/plating,
/area/engineering/main)
"iC" = (
/obj/structure/rack,
/obj/item/storage/toolbox/artistic{
	icon_state = "yellow";
	item_state = "toolbox_yellow";
	name = "Cable Toolbox";
	pixel_y = 6
	},
/obj/item/storage/toolbox/artistic{
	icon_state = "yellow";
	item_state = "toolbox_yellow";
	name = "Cable Toolbox";
	pixel_y = -4
	},
/obj/machinery/firealarm{
	pixel_y = 24
	},
/turf/open/floor/plasteel/dark,
/area/engineering/main)
"iD" = (
/obj/effect/spawner/structure/window/plasma/reinforced,
/turf/open/floor/plating,
/area/engineering/main)
"iJ" = (
/obj/structure/fluff/railing/corner,
/turf/open/floor/plating,
/area/engineering/main)
"jg" = (
/obj/machinery/power/rad_collector,
/obj/effect/turf_decal/box/corners{
	dir = 4
	},
/turf/open/floor/plasteel/dark,
/area/engineering/main)
"jp" = (
/obj/structure/fluff/railing,
/obj/effect/turf_decal/caution,
/turf/open/floor/plating,
/area/engineering/main)
"kg" = (
/obj/effect/turf_decal/box/corners{
	dir = 4
	},
/obj/machinery/portable_atmospherics/canister/nitrogen,
/turf/open/floor/plasteel/dark,
/area/engineering/main)
"kA" = (
/obj/machinery/door/firedoor,
/obj/machinery/door/airlock/engineering/glass{
	name = "Supermatter Engine Room";
	req_access_txt = "10"
	},
/obj/machinery/atmospherics/pipe/simple/supply/hidden,
/turf/open/floor/engine,
/area/engineering/main)
"kW" = (
/obj/machinery/airalarm{
	dir = 4;
	pixel_x = -22
	},
/obj/structure/closet/crate/large,
/obj/item/tank/internals/plasma/full,
/obj/item/tank/internals/plasma/full,
/obj/item/tank/internals/plasma/full,
/obj/item/tank/internals/plasma/full,
/obj/item/tank/internals/plasma/full,
/obj/item/tank/internals/plasma/full,
/turf/open/floor/plasteel/dark,
/area/engineering/main)
"ln" = (
/obj/machinery/power/rad_collector,
/obj/effect/turf_decal/box/corners{
	dir = 8
	},
/turf/open/floor/plasteel/dark,
/area/engineering/main)
"lw" = (
/obj/structure/cable{
	icon_state = "2-4"
	},
/obj/machinery/atmospherics/pipe/simple/scrubbers/visible{
	dir = 4
	},
/turf/open/floor/plating,
/area/engineering/main)
"mj" = (
/obj/effect/turf_decal/stripes/line{
	dir = 8
	},
/obj/machinery/light{
	dir = 8
	},
/turf/open/floor/plating,
/area/engineering/main)
"mH" = (
/obj/structure/sign/poster/official/safety_eye_protection,
/turf/closed/wall/r_wall,
/area/engineering/main)
"mU" = (
/obj/effect/spawner/structure/window/plasma/reinforced,
/obj/machinery/atmospherics/pipe/simple/scrubbers/hidden,
/obj/machinery/atmospherics/pipe/simple/supply/hidden{
	dir = 4
	},
/turf/open/floor/plating,
/area/engineering/main)
"mX" = (
/obj/structure/cable{
	icon_state = "1-8"
	},
/obj/effect/turf_decal/stripes/corner,
/turf/open/floor/plating,
/area/engineering/main)
"nz" = (
/obj/effect/turf_decal/stripes/line{
	dir = 6
	},
/obj/machinery/atmospherics/pipe/simple/supply/hidden{
	dir = 6
	},
/turf/open/floor/plating,
/area/engineering/main)
"nR" = (
/obj/machinery/atmospherics/pipe/simple/supply/hidden{
	dir = 4
	},
/obj/structure/cable/yellow{
	icon_state = "4-8"
	},
/obj/effect/spawner/structure/window/plasma/reinforced,
/turf/open/floor/plating,
/area/engineering/main)
"ou" = (
/obj/machinery/atmospherics/components/unary/portables_connector/visible{
	dir = 4
	},
/turf/open/floor/plasteel,
/area/engineering/main)
"oC" = (
/obj/machinery/atmospherics/pipe/manifold/scrubbers/hidden{
	dir = 1
	},
/obj/effect/spawner/structure/window/plasma/reinforced,
/turf/open/floor/plating,
/area/engineering/main)
"oS" = (
/obj/machinery/door/firedoor,
/obj/machinery/door/airlock/engineering/glass{
	name = "Supermatter Engine Room";
	req_access_txt = "10"
	},
/turf/open/floor/engine,
/area/engineering/main)
"qc" = (
/obj/machinery/power/rad_collector,
/obj/effect/turf_decal/box/corners{
	dir = 1
	},
/obj/machinery/atmospherics/pipe/simple/supply/hidden{
	dir = 4
	},
/turf/open/floor/plasteel/dark,
/area/engineering/main)
"qe" = (
/obj/structure/cable{
	icon_state = "2-8"
	},
/obj/structure/cable{
	icon_state = "4-8"
	},
/obj/effect/turf_decal/stripes/corner{
	dir = 4
	},
/obj/machinery/atmospherics/components/unary/vent_pump/on{
	dir = 1
	},
/turf/open/floor/plating,
/area/engineering/main)
"qr" = (
/obj/machinery/atmospherics/pipe/simple/supply/hidden{
	dir = 4
	},
/obj/structure/cable/yellow{
	icon_state = "2-8"
	},
/obj/structure/cable/yellow{
	icon_state = "4-8"
	},
/obj/effect/turf_decal/stripes/line{
	dir = 1
	},
/turf/open/floor/plating,
/area/engineering/main)
"rJ" = (
/obj/effect/spawner/structure/window/plasma/reinforced,
/obj/machinery/atmospherics/pipe/simple/scrubbers/hidden,
/turf/open/floor/plating,
/area/engineering/main)
"rY" = (
/obj/structure/cable{
	icon_state = "4-8"
	},
/obj/machinery/atmospherics/pipe/simple/scrubbers/visible{
	dir = 10
	},
/turf/open/floor/plating,
/area/engineering/main)
"sn" = (
/obj/machinery/atmospherics/pipe/simple/scrubbers/hidden,
/obj/effect/turf_decal/stripes/line{
	dir = 8
	},
/turf/open/floor/plating,
/area/engineering/main)
"so" = (
/obj/structure/fluff/railing{
	dir = 4
	},
/turf/open/floor/plating,
/area/engineering/main)
"td" = (
/obj/machinery/atmospherics/pipe/simple/scrubbers/hidden{
	dir = 5
	},
/turf/closed/wall/r_wall,
/area/engineering/main)
"tn" = (
/obj/machinery/power/supermatter_crystal/engine,
/turf/open/floor/plating,
/area/engineering/main)
"tw" = (
/obj/structure/lattice,
/turf/open/space/basic,
/area/space/nearstation)
"tJ" = (
/obj/machinery/portable_atmospherics/canister/nitrous_oxide,
/obj/machinery/atmospherics/pipe/simple/supply/hidden,
/turf/open/floor/plasteel/dark,
/area/engineering/main)
"uR" = (
/obj/structure/fluff/railing{
	dir = 1
	},
/turf/open/floor/plating,
/area/engineering/main)
"vX" = (
/obj/structure/cable/yellow{
	icon_state = "2-8"
	},
/obj/machinery/atmospherics/pipe/simple/supply/hidden{
	dir = 4
	},
/obj/effect/turf_decal/stripes/line{
	dir = 1
	},
/turf/open/floor/plating,
/area/engineering/main)
"wt" = (
/obj/structure/closet/radiation,
/obj/item/clothing/suit/radiation,
/obj/item/clothing/head/radiation,
/obj/item/geiger_counter,
/obj/item/clothing/glasses/meson,
/obj/machinery/atmospherics/pipe/simple/scrubbers/hidden{
	dir = 9
	},
/turf/open/floor/plasteel,
/area/engineering/main)
"wG" = (
/obj/effect/turf_decal/stripes/line{
	dir = 8
	},
/obj/machinery/airalarm{
	dir = 4;
	pixel_x = -22
	},
/obj/machinery/atmospherics/pipe/manifold/scrubbers/hidden{
	dir = 4
	},
/turf/open/floor/plating,
/area/engineering/main)
"wS" = (
/turf/open/space,
/area/space/nearstation)
"xe" = (
/obj/machinery/atmospherics/pipe/simple/supply/hidden{
	dir = 5
	},
/turf/closed/wall/r_wall,
/area/engineering/main)
"xo" = (
/obj/item/construction/rcd/loaded/upgraded{
	custom_range = 2;
	matter = 200;
	max_matter = 200;
	name = "Super RCD";
	ranged = 1
	},
/turf/open/floor/plating,
/area/engineering/main)
"yd" = (
/obj/machinery/atmospherics/pipe/manifold/supply/hidden,
/obj/structure/cable/yellow{
	icon_state = "4-8"
	},
/obj/effect/turf_decal/stripes/line{
	dir = 1
	},
/turf/open/floor/plating,
/area/engineering/main)
"yf" = (
/turf/open/space/basic,
/area/space/nearstation)
"yD" = (
/obj/structure/cable{
	icon_state = "1-4"
	},
/obj/effect/turf_decal/stripes/corner{
	dir = 1
	},
/turf/open/floor/plating,
/area/engineering/main)
"zh" = (
/obj/structure/cable/yellow{
	icon_state = "4-8"
	},
/obj/effect/turf_decal/stripes/line{
	dir = 1
	},
/obj/machinery/atmospherics/pipe/simple/supply/hidden{
	dir = 4
	},
/turf/open/floor/plating,
/area/engineering/main)
"zF" = (
/obj/structure/table,
/obj/item/stack/sheet/metal/fifty,
/obj/item/stack/sheet/glass/fifty,
/turf/open/floor/plasteel/dark,
/area/engineering/main)
"zS" = (
/turf/open/space/basic,
/area/space)
"Ab" = (
/obj/structure/rack,
/obj/item/flashlight/seclite,
/obj/item/flashlight,
/turf/open/floor/plasteel/dark,
/area/engineering/main)
"AH" = (
/obj/structure/cable{
	icon_state = "4-8"
	},
/obj/machinery/door/firedoor,
/obj/machinery/door/airlock/engineering/glass{
	name = "Supermatter Engine Room";
	req_access_txt = "10"
	},
/turf/open/floor/engine,
/area/engineering/main)
"Bc" = (
/obj/structure/cable,
/turf/open/floor/plating,
/area/engineering/main)
"Bl" = (
/obj/structure/cable/yellow{
	icon_state = "4-8"
	},
/obj/machinery/atmospherics/pipe/simple/supply/hidden{
	dir = 4
	},
/obj/effect/turf_decal/stripes/line{
	dir = 1
	},
/turf/open/floor/plating,
/area/engineering/main)
"BD" = (
/obj/effect/turf_decal/stripes/line{
	dir = 6
	},
/obj/machinery/atmospherics/components/binary/valve/digital/on{
	dir = 4;
	name = "Output Release"
	},
/obj/item/radio/intercom{
	pixel_y = -25
	},
/turf/open/floor/plating,
/area/engineering/main)
"CH" = (
/obj/machinery/door/firedoor,
/obj/machinery/door/airlock/engineering/glass{
	name = "Supermatter Engine Room";
	req_access_txt = "10"
	},
/turf/open/floor/plasteel/dark,
/area/engineering/main)
"CT" = (
/obj/structure/fluff/railing/corner{
	dir = 8
	},
/turf/open/floor/plating,
/area/engineering/main)
"DC" = (
/obj/structure/rack,
/obj/item/clothing/mask/gas{
	pixel_x = 3;
	pixel_y = 3
	},
/obj/item/clothing/mask/gas,
/obj/item/clothing/mask/gas{
	pixel_x = -3;
	pixel_y = -3
	},
/obj/machinery/atmospherics/pipe/simple/supply/hidden{
	dir = 10
	},
/turf/open/floor/plasteel,
/area/engineering/main)
"Ef" = (
/obj/effect/turf_decal/stripes/line,
/obj/machinery/atmospherics/pipe/simple/scrubbers/visible{
	dir = 4
	},
/turf/open/floor/plating,
/area/engineering/main)
"Ei" = (
/obj/effect/mapping_helpers/airlock/cyclelink_helper{
	dir = 1
	},
/obj/machinery/door/airlock/external{
	name = "Engineering External Access";
	req_access_txt = "10;13"
	},
/turf/open/floor/plating,
/area/engineering/main)
"Es" = (
/obj/effect/turf_decal/stripes/line{
	dir = 4
	},
/obj/machinery/firealarm{
	dir = 4;
	pixel_x = 24
	},
/turf/open/floor/plating,
/area/engineering/main)
"Ex" = (
/obj/effect/turf_decal/stripes/line{
	dir = 10
	},
/obj/machinery/firealarm{
	dir = 1;
	pixel_y = -24
	},
/turf/open/floor/plating,
/area/engineering/main)
"ED" = (
/obj/structure/cable/yellow{
	icon_state = "4-8"
	},
/obj/machinery/atmospherics/pipe/simple/supply/hidden{
	dir = 4
	},
/obj/effect/turf_decal/stripes/line{
	dir = 1
	},
/obj/item/radio/intercom{
	pixel_y = 25
	},
/turf/open/floor/plating,
/area/engineering/main)
"EL" = (
/turf/closed/wall,
/area/engineering/main)
"EM" = (
/obj/item/wrench,
/obj/structure/rack,
/obj/item/weldingtool/hugetank{
	toolspeed = 0.5
	},
/obj/item/clothing/head/welding{
	pixel_x = -3;
	pixel_y = 5
	},
/obj/item/clothing/head/welding{
	pixel_x = -3;
	pixel_y = 5
	},
/obj/item/clothing/glasses/welding,
/obj/item/clothing/glasses/welding,
/turf/open/floor/plasteel/dark,
/area/engineering/main)
"FG" = (
/obj/machinery/atmospherics/pipe/simple/orange/visible{
	dir = 10
	},
/obj/machinery/meter,
/turf/open/floor/plasteel,
/area/engineering/main)
"GB" = (
/obj/structure/cable/yellow{
	icon_state = "4-8"
	},
/obj/machinery/atmospherics/pipe/simple/supply/hidden{
	dir = 4
	},
/obj/machinery/atmospherics/pipe/simple/scrubbers/hidden,
/obj/effect/spawner/structure/window/plasma/reinforced,
/turf/open/floor/plating,
/area/engineering/main)
"GI" = (
/obj/machinery/firealarm{
	dir = 4;
	pixel_x = 24
	},
/turf/open/floor/plasteel/dark,
/area/engineering/main)
"GK" = (
/obj/machinery/atmospherics/pipe/simple/scrubbers/hidden,
/obj/effect/turf_decal/stripes/line{
	dir = 8
	},
/obj/machinery/camera{
	c_tag = "Engineering Supermatter Port";
	dir = 4;
	network = list("ss13","engine")
	},
/obj/item/radio/intercom{
	pixel_x = -25
	},
/turf/open/floor/plating,
/area/engineering/main)
"GX" = (
/obj/structure/cable/yellow,
/turf/open/floor/plating,
/area/engineering/main)
"Hn" = (
/obj/machinery/atmospherics/components/unary/outlet_injector/atmos/engine_waste{
	dir = 1
	},
/turf/open/floor/plating/airless,
/area/engineering/main)
"Hz" = (
/obj/structure/cable/yellow{
	icon_state = "1-2"
	},
/obj/structure/cable{
	icon_state = "4-8"
	},
/turf/open/floor/plating,
/area/engineering/main)
"In" = (
/obj/machinery/atmospherics/pipe/simple/supply/hidden,
/obj/machinery/atmospherics/pipe/simple/scrubbers/visible{
	dir = 4
	},
/turf/closed/wall/r_wall,
/area/engineering/main)
"IE" = (
/obj/structure/cable{
	icon_state = "1-2"
	},
/obj/effect/turf_decal/stripes/line,
/obj/machinery/atmospherics/pipe/simple/scrubbers/visible{
	dir = 4
	},
/turf/open/floor/plating,
/area/engineering/main)
"Jn" = (
/obj/machinery/light,
/obj/machinery/power/rad_collector,
/obj/machinery/atmospherics/pipe/simple/supply/hidden{
	dir = 9
	},
/turf/open/floor/plasteel/dark,
/area/engineering/main)
"JV" = (
/obj/machinery/door/firedoor,
/obj/machinery/door/airlock/engineering/glass{
	name = "Laser Room";
	req_access_txt = "10"
	},
/obj/structure/cable{
	icon_state = "1-2"
	},
/turf/open/floor/plating,
/area/engineering/main)
"Ke" = (
/obj/structure/table,
/obj/item/stack/cable_coil/yellow{
	pixel_y = 10
	},
/obj/item/stack/cable_coil/yellow{
	pixel_y = 5
	},
/obj/item/stack/cable_coil/yellow,
/obj/item/radio/intercom{
	pixel_y = -25
	},
/turf/open/floor/plasteel,
/area/engineering/main)
"Kv" = (
/obj/effect/turf_decal/stripes/line{
	dir = 4
	},
/obj/machinery/light{
	dir = 4
	},
/turf/open/floor/plating,
/area/engineering/main)
"Lg" = (
/obj/structure/cable{
	icon_state = "2-8"
	},
/obj/effect/turf_decal/stripes/corner{
	dir = 8
	},
/obj/machinery/atmospherics/components/unary/vent_scrubber/on{
	dir = 4
	},
/turf/open/floor/plating,
/area/engineering/main)
"Lw" = (
/obj/machinery/light{
	dir = 1
	},
/turf/open/floor/plating,
/area/engineering/main)
"LJ" = (
/obj/machinery/light,
/turf/open/floor/plating,
/area/engineering/main)
"LS" = (
/obj/machinery/atmospherics/pipe/simple/scrubbers/visible,
/turf/open/floor/plating/airless,
/area/engineering/main)
"My" = (
/obj/effect/spawner/structure/window/plasma/reinforced,
/obj/machinery/atmospherics/pipe/simple/scrubbers/hidden{
	dir = 6
	},
/turf/open/floor/plating,
/area/engineering/main)
"ME" = (
/obj/machinery/atmospherics/pipe/simple/scrubbers/hidden{
	dir = 9
	},
/obj/effect/spawner/structure/window/plasma/reinforced,
/turf/open/floor/plating,
/area/engineering/main)
"MI" = (
/obj/machinery/atmospherics/components/unary/vent_pump/on{
	dir = 1
	},
/turf/open/floor/plasteel/dark,
/area/engineering/main)
"MJ" = (
/turf/open/floor/plating,
/area/engineering/main)
"MP" = (
/turf/closed/wall/r_wall,
/area/engineering/main)
"Ne" = (
/obj/machinery/atmospherics/pipe/simple/supply/hidden,
/obj/effect/spawner/structure/window/plasma/reinforced,
/turf/open/floor/plating,
/area/engineering/main)
"Np" = (
/obj/machinery/atmospherics/components/unary/portables_connector/visible{
	dir = 4
	},
/turf/open/floor/plating,
/area/engineering/main)
"ND" = (
/obj/effect/mapping_helpers/airlock/cyclelink_helper,
/obj/machinery/door/airlock/external{
	name = "Engineering External Access";
	req_access_txt = "10;13"
	},
/turf/open/floor/plating,
/area/engineering/main)
"NK" = (
/obj/structure/closet/crate/large,
/obj/item/stack/sheet/metal/fifty,
/obj/item/stack/sheet/metal/fifty,
/obj/item/stack/sheet/metal/fifty,
/obj/item/stack/sheet/metal/fifty,
/obj/item/stack/rods/fifty,
/obj/item/stack/rods/fifty,
/obj/item/stack/rods/fifty,
/obj/machinery/atmospherics/pipe/simple/supply/hidden,
/turf/open/floor/plasteel/dark,
/area/engineering/main)
"NZ" = (
/obj/machinery/atmospherics/pipe/simple/orange/visible{
	dir = 5
	},
/obj/item/radio/intercom{
	pixel_y = -25
	},
/turf/open/floor/plasteel,
/area/engineering/main)
"Oj" = (
/turf/closed/wall/r_wall,
/area/space/nearstation)
"Ok" = (
/turf/open/floor/plasteel,
/area/engineering/main)
"OB" = (
/obj/effect/spawner/structure/window/plasma/reinforced,
/obj/machinery/atmospherics/pipe/simple/supply/hidden,
/turf/open/floor/plating,
/area/engineering/main)
"OK" = (
/obj/structure/cable{
	icon_state = "1-2"
	},
/turf/open/floor/plating,
/area/engineering/main)
"OU" = (
/obj/machinery/atmospherics/pipe/simple/orange/visible{
	dir = 4
	},
/obj/machinery/meter,
/turf/open/floor/plasteel,
/area/engineering/main)
"Pp" = (
/obj/machinery/atmospherics/pipe/manifold/supply/hidden{
	dir = 4
	},
/turf/open/floor/plasteel/dark,
/area/engineering/main)
"Py" = (
/obj/machinery/atmospherics/pipe/simple/scrubbers/visible{
	dir = 4
	},
/obj/effect/turf_decal/stripes/line,
/turf/open/floor/plating,
/area/engineering/main)
"Qn" = (
/obj/effect/turf_decal/stripes/line,
/obj/machinery/atmospherics/pipe/manifold/scrubbers/visible,
/obj/machinery/meter,
/turf/open/floor/plating,
/area/engineering/main)
"QD" = (
/obj/structure/cable{
	icon_state = "4-8"
	},
/turf/open/floor/plating,
/area/engineering/main)
"Rh" = (
/obj/structure/lattice,
/turf/open/space,
/area/space/nearstation)
"SR" = (
/obj/effect/turf_decal/stripes/line,
/obj/machinery/atmospherics/pipe/simple/scrubbers/visible{
	dir = 6
	},
/turf/open/floor/plating,
/area/engineering/main)
"SX" = (
/obj/effect/spawner/structure/window/plasma/reinforced,
/obj/machinery/atmospherics/pipe/manifold/scrubbers/hidden{
	dir = 4
	},
/turf/open/floor/plating,
/area/engineering/main)
"Tk" = (
/obj/machinery/light/small{
	dir = 8
	},
/obj/structure/closet/emcloset/anchored,
/turf/open/floor/plating,
/area/engineering/main)
"TB" = (
/obj/machinery/light{
	dir = 4
	},
/obj/machinery/camera{
	c_tag = "Engineering Supermatter Starboard";
	dir = 8;
	network = list("ss13","engine")
	},
/obj/effect/turf_decal/box/corners{
	dir = 8
	},
/obj/machinery/portable_atmospherics/canister/nitrogen,
/turf/open/floor/plasteel/dark,
/area/engineering/main)
"TC" = (
/obj/machinery/atmospherics/components/unary/vent_scrubber/on{
	dir = 1
	},
/obj/effect/turf_decal/stripes/line{
	dir = 8
	},
/turf/open/floor/plating,
/area/engineering/main)
"Ub" = (
/obj/machinery/atmospherics/pipe/simple/supply/hidden{
	dir = 9
	},
/turf/closed/wall/r_wall,
/area/engineering/main)
"Uo" = (
/obj/machinery/airalarm{
	dir = 8;
	pixel_x = 22
	},
/turf/open/floor/plasteel/dark,
/area/engineering/main)
"Uq" = (
/obj/machinery/atmospherics/pipe/simple/supply/hidden{
	dir = 4
	},
/turf/closed/wall/r_wall,
/area/engineering/main)
"Ur" = (
/obj/effect/turf_decal/stripes/line{
	dir = 4
	},
/turf/open/floor/plating,
/area/engineering/main)
"Uu" = (
/turf/open/floor/plasteel/dark,
/area/engineering/main)
"UM" = (
/obj/structure/fluff/railing{
	dir = 8
	},
/turf/open/floor/plating,
/area/engineering/main)
"UN" = (
/obj/structure/cable{
	icon_state = "4-8"
	},
/obj/machinery/atmospherics/pipe/simple/scrubbers/hidden,
/obj/effect/turf_decal/stripes/line{
	dir = 9
	},
/turf/open/floor/plating,
/area/engineering/main)
"Vn" = (
/obj/machinery/atmospherics/pipe/simple/scrubbers/hidden,
/turf/open/floor/plasteel/dark,
/area/engineering/main)
"VG" = (
/obj/machinery/atmospherics/pipe/simple/scrubbers/hidden,
/obj/effect/turf_decal/stripes/line{
	dir = 8
	},
/obj/machinery/firealarm{
	dir = 8;
	pixel_x = -24
	},
/turf/open/floor/plating,
/area/engineering/main)
"WB" = (
/obj/structure/lattice,
/obj/structure/grille,
/turf/open/space/basic,
/area/space/nearstation)
"WI" = (
/obj/structure/cable{
	icon_state = "2-8"
	},
/turf/open/floor/plating,
/area/engineering/main)
"WP" = (
/obj/machinery/atmospherics/components/unary/vent_pump/on{
	dir = 4
	},
/turf/open/floor/plasteel/dark,
/area/engineering/main)
"XA" = (
/obj/machinery/atmospherics/pipe/simple/scrubbers/hidden{
	dir = 10
	},
/turf/closed/wall/r_wall,
/area/engineering/main)
"XK" = (
/obj/machinery/power/rad_collector,
/obj/effect/turf_decal/box/corners,
/turf/open/floor/plasteel/dark,
/area/engineering/main)
"YB" = (
/obj/structure/cable{
	icon_state = "0-5"
	},
/obj/machinery/power/floodlight,
/turf/open/floor/plating,
/area/engineering/main)
"YX" = (
/obj/item/stack/rods/fifty,
/turf/open/floor/plating,
/area/engineering/main)
"YZ" = (
/obj/structure/lattice,
/obj/structure/grille,
/turf/open/space,
/area/space/nearstation)
"Zn" = (
/obj/structure/sign/warning/vacuum/external{
	pixel_x = 32
	},
/turf/open/floor/plating,
/area/engineering/main)
"ZH" = (
/obj/machinery/atmospherics/pipe/simple/supply/hidden,
/turf/open/floor/plasteel/dark,
/area/engineering/main)
"ZT" = (
/turf/template_noop,
/area/template_noop)

(1,1,1) = {"
ZT
ZT
ZT
ZT
ZT
ZT
ZT
yf
Rh
yf
yf
Rh
yf
yf
Rh
yf
yf
yf
YZ
YZ
YZ
ZT
ZT
ZT
ZT
ZT
"}
(2,1,1) = {"
ZT
ZT
ZT
ZT
ZT
ZT
ZT
Rh
Rh
Rh
Rh
Rh
Rh
Rh
Rh
Rh
yf
yf
YZ
Oj
YZ
ZT
ZT
ZT
ZT
ZT
"}
(3,1,1) = {"
ZT
ZT
ZT
ZT
ZT
ZT
ZT
Rh
dw
Rh
Rh
dw
Rh
Rh
dw
Rh
Rh
Rh
YZ
Oj
YZ
ZT
ZT
ZT
ZT
ZT
"}
(4,1,1) = {"
ZT
ZT
ZT
ZT
ZT
ZT
ZT
Rh
dw
Rh
Rh
dw
Rh
Rh
dw
Rh
yf
yf
YZ
Oj
YZ
ZT
ZT
ZT
ZT
ZT
"}
(5,1,1) = {"
ZT
ZT
ZT
ZT
ZT
ZT
ZT
Rh
dw
Rh
Rh
dw
Rh
Rh
dw
Rh
Rh
Rh
YZ
Oj
YZ
ZT
ZT
ZT
ZT
ZT
"}
(6,1,1) = {"
ZT
ZT
ZT
ZT
ZT
ZT
ZT
wS
dw
Rh
Rh
dw
Rh
Rh
dw
Rh
yf
yf
YZ
Oj
YZ
ZT
ZT
ZT
ZT
ZT
"}
(7,1,1) = {"
ZT
ZT
ZT
ZT
EL
EL
MP
Rh
dw
Rh
Rh
dw
Rh
Rh
dw
Rh
Rh
Rh
YZ
Oj
YZ
yf
yf
yf
yf
zS
"}
(8,1,1) = {"
ZT
ZT
cP
Ke
EL
Tk
MP
wS
dw
Rh
Rh
dw
Rh
Rh
dw
Rh
yf
yf
YZ
Oj
YZ
yf
yf
Rh
yf
yf
"}
(9,1,1) = {"
ZT
ZT
dl
Ok
ND
Zn
Ei
Rh
dw
Rh
Rh
dw
Rh
Rh
dw
Rh
Rh
Rh
YZ
YZ
YZ
tw
Rh
Rh
Rh
yf
"}
(10,1,1) = {"
ZT
nR
AH
iD
MP
MP
MP
MP
aA
rJ
gf
rJ
rJ
td
yf
yf
yf
yf
Rh
yf
yf
yf
yf
Rh
yf
yf
"}
(11,1,1) = {"
oC
GB
UN
sn
VG
ad
sn
GK
wG
TC
mj
fW
at
XA
td
MP
MP
MP
MP
MP
MP
yf
WB
YZ
WB
yf
"}
(12,1,1) = {"
cS
hJ
qe
OK
OK
OK
OK
OK
OK
OK
OK
OK
yD
Ex
ck
iC
ez
kW
ez
EM
MP
yf
YZ
Oj
YZ
yf
"}
(13,1,1) = {"
ME
qr
Hz
GX
MJ
MJ
MJ
MJ
MJ
MJ
MJ
MJ
QD
SR
SX
Vn
Vn
cp
Uu
Uu
MP
yf
YZ
Oj
YZ
yf
"}
(14,1,1) = {"
Ne
yd
QD
MJ
MJ
MJ
MJ
MJ
YX
MJ
MJ
MJ
WI
IE
JV
Bc
MJ
MJ
MJ
LJ
MP
Rh
YZ
Oj
YZ
Rh
"}
(15,1,1) = {"
MP
zh
QD
MJ
MJ
MJ
MJ
MJ
MJ
MJ
MJ
MJ
MJ
Ef
iD
MJ
MJ
MJ
MJ
MJ
MP
yf
YZ
Oj
YZ
yf
"}
(16,1,1) = {"
MP
Bl
QD
MJ
MJ
MJ
MJ
MJ
MJ
MJ
MJ
MJ
MJ
ej
MP
Lw
MJ
MJ
MJ
MJ
MP
Rh
YZ
Oj
YZ
yf
"}
(17,1,1) = {"
oS
Bl
QD
MJ
MJ
MJ
iJ
so
aV
MJ
MJ
MJ
MJ
Py
iD
MJ
MJ
MJ
MJ
MJ
MP
yf
YZ
Oj
YZ
yf
"}
(18,1,1) = {"
iD
aa
QD
YX
MJ
MJ
jp
tn
uR
MJ
MJ
MJ
ac
ey
iD
MJ
MJ
xo
MJ
MJ
MP
yf
YZ
Oj
YZ
yf
"}
(19,1,1) = {"
oS
Bl
QD
MJ
MJ
MJ
CT
UM
aX
MJ
MJ
MJ
MJ
Py
iD
MJ
MJ
MJ
MJ
MJ
MP
Rh
YZ
Oj
YZ
yf
"}
(20,1,1) = {"
MP
Bl
QD
MJ
MJ
MJ
MJ
MJ
MJ
MJ
MJ
MJ
MJ
ej
MP
Lw
MJ
MJ
MJ
MJ
MP
Rh
YZ
Oj
YZ
yf
"}
(21,1,1) = {"
MP
ED
QD
MJ
MJ
MJ
MJ
MJ
MJ
MJ
MJ
MJ
Np
Ef
iD
MJ
MJ
MJ
MJ
MJ
MP
yf
YZ
Oj
YZ
yf
"}
(22,1,1) = {"
iD
Bl
QD
MJ
MJ
MJ
MJ
MJ
MJ
MJ
YX
MJ
lw
bH
JV
Bc
MJ
MJ
MJ
LJ
MP
Rh
YZ
Oj
YZ
Rh
"}
(23,1,1) = {"
iD
vX
Hz
GX
MJ
MJ
MJ
YB
MJ
MJ
MJ
MJ
rY
Qn
ab
ZH
ZH
MI
Uu
Uu
MP
Rh
YZ
Oj
YZ
yf
"}
(24,1,1) = {"
mH
bT
Lg
OK
OK
OK
af
OK
OK
OK
OK
OK
mX
BD
Uq
zF
fj
fK
fj
Ab
MP
Rh
YZ
Oj
YZ
yf
"}
(25,1,1) = {"
My
mU
in
Ur
Es
Kv
Ur
Ur
Ur
Ur
Ur
Ur
nz
In
Ub
MP
MP
MP
MP
MP
MP
yf
YZ
YZ
YZ
yf
"}
(26,1,1) = {"
wt
av
kA
OB
xe
MP
ag
WP
kg
bI
Uu
jg
qc
fq
LS
Hn
dw
yf
Rh
yf
yf
yf
yf
Rh
yf
yf
"}
(27,1,1) = {"
ZT
ZT
ZT
ou
DC
OB
ah
Pp
tJ
NK
ZH
dD
Jn
MP
dw
dw
dw
Rh
Rh
Rh
Rh
tw
Rh
Rh
Rh
Rh
"}
(28,1,1) = {"
ZT
ZT
ZT
OU
Ok
CH
GI
Uo
TB
gQ
Uu
ln
XK
MP
yf
yf
Rh
yf
Rh
Oj
YZ
yf
yf
Rh
yf
yf
"}
(29,1,1) = {"
ZT
ZT
ZT
FG
NZ
MP
MP
MP
MP
MP
iD
iD
iD
MP
Rh
Rh
Rh
Rh
Rh
Oj
YZ
yf
yf
Rh
yf
zS
"}
