//MAP CONVERTED BY dmm2tgm.py THIS HEADER COMMENT PREVENTS RECONVERSION, DO NOT REMOVE
"ab" = (
/obj/machinery/light/small{
	dir = 4
	},
/obj/structure/extinguisher_cabinet{
	pixel_x = 25
	},
/obj/structure/table,
/obj/item/paper_bin,
/obj/item/paper/fluff/ruins/listeningstation/reports/november,
/obj/item/pen,
/turf/open/floor/plasteel/dark,
/area/ruin/space/syndielistenspace)
"ae" = (
/turf/template_noop,
/area/template_noop)
"ag" = (
/obj/structure/sink{
	dir = 4;
	pixel_x = 11
	},
/obj/structure/toilet{
	pixel_y = 18
	},
/obj/structure/mirror{
	pixel_x = 28
	},
/obj/effect/decal/cleanable/dirt,
/turf/open/floor/plasteel/showroomfloor,
/area/ruin/space/syndielistenspace)
"ax" = (
/obj/machinery/atmospherics/components/unary/outlet_injector/on{
	dir = 8;
	piping_layer = 3;
	pixel_x = 5;
	pixel_y = 5
	},
/turf/open/floor/plating/airless,
/area/ruin/space/syndielistenspace)
"bk" = (
/obj/structure/rack{
	dir = 8;
	layer = 2.9
	},
/obj/item/mining_scanner,
/obj/item/pickaxe,
/obj/effect/decal/cleanable/dirt,
/obj/item/mop/advanced,
/turf/open/floor/plasteel/dark,
/area/ruin/space/syndielistenspace)
"bn" = (
/obj/effect/decal/cleanable/dirt,
/obj/machinery/power/terminal{
	dir = 1
	},
/obj/structure/cable{
	icon_state = "0-2";
	pixel_y = 1
	},
/obj/structure/reagent_dispensers/fueltank,
/obj/item/clothing/head/welding,
/obj/item/weldingtool/largetank,
/turf/open/floor/plating,
/area/ruin/space/syndielistenspace)
"bX" = (
/obj/machinery/atmospherics/pipe/simple/supply/hidden,
/obj/machinery/atmospherics/pipe/simple/scrubbers/hidden{
	piping_layer = 3;
	pixel_x = 5;
	pixel_y = 5
	},
/obj/effect/turf_decal/tile/neutral{
	dir = 1
	},
/obj/effect/turf_decal/tile/neutral,
/obj/effect/turf_decal/tile/neutral{
	dir = 4
	},
/obj/effect/turf_decal/tile/neutral{
	dir = 8
	},
/turf/open/floor/plasteel/dark,
/area/ruin/space/syndielistenspace)
"ff" = (
/obj/machinery/door/firedoor,
/obj/effect/decal/cleanable/dirt,
/obj/machinery/atmospherics/pipe/simple/supply/hidden,
/obj/machinery/atmospherics/pipe/simple/scrubbers/hidden{
	piping_layer = 3;
	pixel_x = 5;
	pixel_y = 5
	},
/obj/machinery/door/airlock/medical/glass{
	name = "Medbay"
	},
/turf/open/floor/plasteel/white,
/area/ruin/space/syndielistenspace)
"fm" = (
/obj/effect/decal/cleanable/dirt,
/obj/effect/decal/cleanable/dirt,
/obj/structure/closet/secure_closet/medical1{
	req_access = null;
	req_access_txt = "150"
	},
/turf/open/floor/plasteel/white,
/area/ruin/space/syndielistenspace)
"fs" = (
/obj/machinery/atmospherics/pipe/simple/supply/hidden,
/obj/effect/decal/cleanable/dirt,
/turf/open/floor/plasteel,
/area/ruin/space/syndielistenspace)
"fW" = (
/obj/machinery/atmospherics/pipe/simple/supply/hidden,
/obj/machinery/meter,
/obj/effect/turf_decal/stripes/line,
/turf/open/floor/plating,
/area/ruin/space/syndielistenspace)
"gu" = (
/obj/effect/decal/cleanable/dirt,
/obj/machinery/atmospherics/pipe/simple/supply/hidden{
	dir = 4
	},
/obj/machinery/atmospherics/pipe/simple/scrubbers/hidden{
	dir = 4;
	piping_layer = 3;
	pixel_x = 5;
	pixel_y = 5
	},
/obj/effect/turf_decal/tile/red{
	dir = 4
	},
/turf/open/floor/plasteel,
/area/ruin/space/syndielistenspace)
"gN" = (
/obj/machinery/light/small{
	dir = 1
	},
/obj/machinery/firealarm{
	dir = 2;
	pixel_y = 24
	},
/obj/machinery/atmospherics/pipe/simple/supply/hidden{
	dir = 4
	},
/obj/machinery/atmospherics/pipe/manifold/scrubbers/hidden{
	dir = 1;
	piping_layer = 3;
	pixel_x = 5;
	pixel_y = 5
	},
/obj/effect/turf_decal/tile/red{
	dir = 1
	},
/obj/effect/turf_decal/tile/red{
	dir = 4
	},
/turf/open/floor/plasteel,
/area/ruin/space/syndielistenspace)
"hg" = (
/obj/machinery/atmospherics/pipe/simple/supply/hidden,
/obj/machinery/atmospherics/pipe/simple/scrubbers/hidden{
	dir = 9;
	piping_layer = 3;
	pixel_x = 5;
	pixel_y = 5
	},
/turf/open/floor/plasteel/white/side{
	dir = 5
	},
/area/ruin/space/syndielistenspace)
"hs" = (
/obj/machinery/atmospherics/pipe/manifold/supply/hidden,
/obj/machinery/atmospherics/pipe/manifold/scrubbers/hidden{
	dir = 2;
	piping_layer = 3;
	pixel_x = 5;
	pixel_y = 5
	},
/obj/effect/turf_decal/tile/red{
	dir = 1
	},
/obj/effect/turf_decal/tile/red{
	dir = 4
	},
/turf/open/floor/plasteel,
/area/ruin/space/syndielistenspace)
"ia" = (
/obj/machinery/atmospherics/pipe/simple/supply/hidden,
/obj/machinery/atmospherics/pipe/simple/scrubbers/hidden{
	piping_layer = 3;
	pixel_x = 5;
	pixel_y = 5
	},
/turf/open/floor/plasteel/white/side,
/area/ruin/space/syndielistenspace)
"ii" = (
/obj/machinery/computer/message_monitor{
	dir = 2
	},
/obj/machinery/airalarm/syndicate{
	pixel_y = 24
	},
/obj/effect/decal/cleanable/dirt,
/obj/effect/decal/cleanable/dirt,
/obj/item/paper/monitorkey,
/turf/open/floor/plasteel/dark,
/area/ruin/space/syndielistenspace)
"kd" = (
/obj/structure/table,
/obj/item/storage/firstaid/regular,
/obj/item/clothing/neck/stethoscope,
/obj/effect/decal/cleanable/dirt,
/turf/open/floor/plasteel/white/side{
	dir = 10
	},
/area/ruin/space/syndielistenspace)
"kE" = (
/obj/effect/decal/cleanable/dirt,
/obj/machinery/atmospherics/components/unary/vent_pump/on{
	dir = 1
	},
/obj/structure/extinguisher_cabinet{
	pixel_y = -29
	},
/turf/open/floor/plasteel,
/area/ruin/space/syndielistenspace)
"kO" = (
/obj/machinery/washing_machine{
	pixel_x = 4
	},
/obj/structure/window{
	dir = 8
	},
/obj/effect/decal/cleanable/dirt,
/obj/effect/decal/cleanable/dirt,
/obj/effect/turf_decal/tile/neutral{
	dir = 1
	},
/obj/effect/turf_decal/tile/neutral,
/obj/effect/turf_decal/tile/neutral{
	dir = 4
	},
/obj/effect/turf_decal/tile/neutral{
	dir = 8
	},
/turf/open/floor/plasteel/dark,
/area/ruin/space/syndielistenspace)
"lp" = (
/obj/effect/decal/cleanable/dirt,
/obj/machinery/atmospherics/pipe/simple/supply/hidden,
/obj/machinery/atmospherics/pipe/manifold/scrubbers/hidden{
	dir = 8;
	piping_layer = 3;
	pixel_x = 5;
	pixel_y = 5
	},
/obj/effect/turf_decal/tile/neutral{
	dir = 1
	},
/obj/effect/turf_decal/tile/neutral,
/obj/effect/turf_decal/tile/neutral{
	dir = 4
	},
/obj/effect/turf_decal/tile/neutral{
	dir = 8
	},
/turf/open/floor/plasteel/dark,
/area/ruin/space/syndielistenspace)
"lW" = (
/obj/effect/turf_decal/tile/neutral{
	dir = 1
	},
/obj/effect/turf_decal/tile/neutral,
/obj/effect/turf_decal/tile/neutral{
	dir = 4
	},
/obj/effect/turf_decal/tile/neutral{
	dir = 8
	},
/obj/structure/closet/crate/bin,
/turf/open/floor/plasteel/dark,
/area/ruin/space/syndielistenspace)
"mh" = (
/obj/docking_port/stationary{
	dir = 4;
	dwidth = 6;
	height = 7;
	id = "caravansyndicate3_listeningpost";
	name = "Syndicate Listening Post";
	width = 15
	},
/obj/docking_port/stationary{
	dir = 4;
	dwidth = 4;
	height = 5;
	id = "caravansyndicate1_listeningpost";
	name = "Syndicate Listening Post";
	width = 9
	},
/turf/template_noop,
/area/template_noop)
"mU" = (
/obj/machinery/atmospherics/pipe/simple/supply/hidden,
/obj/machinery/atmospherics/pipe/simple/scrubbers/hidden{
	dir = 10;
	piping_layer = 3;
	pixel_x = 5;
	pixel_y = 5
	},
/obj/effect/turf_decal/tile/neutral{
	dir = 1
	},
/obj/effect/turf_decal/tile/neutral,
/obj/effect/turf_decal/tile/neutral{
	dir = 4
	},
/obj/effect/turf_decal/tile/neutral{
	dir = 8
	},
/turf/open/floor/plasteel/dark,
/area/ruin/space/syndielistenspace)
"mZ" = (
/obj/structure/closet/crate/freezer,
/obj/item/reagent_containers/blood/OMinus{
	pixel_x = -3;
	pixel_y = 3
	},
/obj/item/reagent_containers/blood/OMinus,
/obj/effect/decal/cleanable/dirt,
/obj/machinery/atmospherics/components/unary/vent_scrubber/on{
	dir = 4;
	piping_layer = 3;
	pixel_x = 5;
	pixel_y = 5
	},
/turf/open/floor/plasteel/white/side{
	dir = 9
	},
/area/ruin/space/syndielistenspace)
"pa" = (
/obj/machinery/atmospherics/components/unary/vent_scrubber/on{
	dir = 8;
	piping_layer = 3;
	pixel_x = 5;
	pixel_y = 5
	},
/obj/effect/mob_spawn/human/space/syndicate/comms{
	dir = 8
	},
/turf/open/floor/plasteel/grimy,
/area/ruin/space/syndielistenspace)
"pV" = (
/obj/machinery/light/small,
/obj/structure/sign/warning/vacuum{
	pixel_y = 32
	},
/obj/effect/decal/cleanable/dirt,
/turf/open/floor/plating,
/area/ruin/space/syndielistenspace)
"qp" = (
/obj/machinery/atmospherics/components/unary/tank/air{
	dir = 1
	},
/obj/effect/turf_decal/bot,
/obj/effect/decal/cleanable/dirt,
/obj/effect/decal/cleanable/dirt,
/turf/open/floor/plating,
/area/ruin/space/syndielistenspace)
"qH" = (
/obj/structure/table/wood,
/obj/item/ammo_box/magazine/m10mm,
/obj/item/paper/fluff/ruins/listeningstation/briefing,
/turf/open/floor/plasteel/grimy,
/area/ruin/space/syndielistenspace)
"rr" = (
/obj/machinery/atmospherics/pipe/simple/scrubbers/hidden{
	dir = 4;
	piping_layer = 3;
	pixel_x = 5;
	pixel_y = 5
	},
/turf/closed/wall/r_wall,
/area/ruin/space/syndielistenspace)
"rJ" = (
/obj/machinery/vending/cola/random{
	extended_inventory = 1
	},
/obj/effect/decal/cleanable/dirt,
/obj/effect/decal/cleanable/dirt,
/turf/open/floor/plasteel/white/corner{
	dir = 8
	},
/area/ruin/space/syndielistenspace)
"te" = (
/obj/effect/mapping_helpers/airlock/cyclelink_helper{
	dir = 8
	},
/obj/machinery/door/airlock/external{
	id_tag = "syndie_listeningpost_external";
	req_access_txt = "150"
	},
/obj/structure/fans/tiny,
/turf/open/floor/plating,
/area/ruin/space/syndielistenspace)
"tg" = (
/obj/structure/table,
/obj/machinery/light/small{
	brightness = 3;
	dir = 8
	},
/obj/item/storage/box/donkpockets{
	pixel_x = -2;
	pixel_y = 6
	},
/obj/item/storage/box/donkpockets{
	pixel_y = 3
	},
/obj/item/storage/box/donkpockets{
	pixel_x = 2
	},
/obj/item/reagent_containers/food/snacks/chocolatebar,
/obj/effect/decal/cleanable/dirt,
/obj/effect/decal/cleanable/dirt,
/obj/structure/sign/poster/contraband/random{
	pixel_x = -32
	},
/obj/effect/turf_decal/tile/neutral{
	dir = 1
	},
/obj/effect/turf_decal/tile/neutral,
/obj/effect/turf_decal/tile/neutral{
	dir = 4
	},
/obj/effect/turf_decal/tile/neutral{
	dir = 8
	},
/turf/open/floor/plasteel/dark,
/area/ruin/space/syndielistenspace)
"ty" = (
/obj/effect/decal/cleanable/dirt,
/obj/machinery/atmospherics/components/unary/vent_pump/on{
	dir = 4
	},
/turf/open/floor/plasteel,
/area/ruin/space/syndielistenspace)
"ui" = (
/obj/effect/turf_decal/stripes/line{
	dir = 8
	},
/obj/structure/tank_dispenser/oxygen{
	oxygentanks = 4
	},
/obj/effect/decal/cleanable/dirt,
/obj/machinery/atmospherics/pipe/simple/scrubbers/hidden{
	dir = 4;
	piping_layer = 3;
	pixel_x = 5;
	pixel_y = 5
	},
/turf/open/floor/mineral/plastitanium,
/area/ruin/space/syndielistenspace)
"ve" = (
/obj/structure/sign/departments/medbay/alt,
/turf/closed/wall,
/area/ruin/space/syndielistenspace)
"vj" = (
/obj/effect/turf_decal/stripes/red/corner{
	dir = 1
	},
/obj/machinery/door/airlock{
	name = "Cabin"
	},
/obj/machinery/atmospherics/pipe/simple/supply/hidden,
/obj/machinery/atmospherics/pipe/simple/scrubbers/hidden{
	piping_layer = 3;
	pixel_x = 5;
	pixel_y = 5
	},
/turf/open/floor/plasteel,
/area/ruin/space/syndielistenspace)
"vH" = (
/obj/machinery/door/firedoor,
/obj/machinery/atmospherics/pipe/simple/supply/hidden{
	dir = 4
	},
/obj/machinery/atmospherics/pipe/simple/scrubbers/hidden{
	dir = 4;
	piping_layer = 3;
	pixel_x = 5;
	pixel_y = 5
	},
/obj/machinery/door/airlock{
	name = "Personal Quarters"
	},
/turf/open/floor/plasteel,
/area/ruin/space/syndielistenspace)
"vJ" = (
/obj/machinery/atmospherics/pipe/simple/supply/hidden,
/obj/effect/decal/cleanable/dirt,
/obj/machinery/power/apc/syndicate{
	dir = 4;
	name = "Syndicate Listening Post APC";
	pixel_x = 24;
	areastring = "/area/ruin/space/syndielistenspace"
	},
/obj/structure/cable,
/turf/open/floor/plating,
/area/ruin/space/syndielistenspace)
"vP" = (
/obj/machinery/door/airlock/maintenance,
/obj/machinery/atmospherics/pipe/simple/supply/hidden,
/turf/open/floor/plating,
/area/ruin/space/syndielistenspace)
"wW" = (
/obj/machinery/door/airlock{
	name = "Toilet"
	},
/turf/open/floor/plasteel/showroomfloor,
/area/ruin/space/syndielistenspace)
"xh" = (
/obj/structure/rack{
	dir = 8
	},
/obj/item/multitool,
/obj/effect/decal/cleanable/dirt,
/turf/open/floor/plasteel/dark,
/area/ruin/space/syndielistenspace)
"xw" = (
/obj/structure/chair/stool,
/obj/machinery/atmospherics/components/unary/vent_scrubber/on{
	dir = 4;
	piping_layer = 3;
	pixel_x = 5;
	pixel_y = 5
	},
/turf/open/floor/plasteel,
/area/ruin/space/syndielistenspace)
"yi" = (
/obj/machinery/syndicatebomb/self_destruct{
	anchored = 1
	},
/obj/structure/sign/warning/securearea{
	desc = "A warning sign which reads 'DANGER: SELF DESTRUCT DEVICE'.";
	name = "DANGER: SELF DESTRUCT DEVICE";
	pixel_x = 32
	},
/obj/machinery/door/window/brigdoor{
	dir = 8;
	req_access_txt = "150"
	},
/turf/open/floor/circuit/red,
/area/ruin/space/syndielistenspace)
"yy" = (
/obj/structure/table,
/obj/machinery/cell_charger,
/obj/item/stock_parts/cell/high/plus,
/obj/item/stack/cable_coil{
	pixel_x = 3;
	pixel_y = -7
	},
/obj/effect/decal/cleanable/dirt,
/obj/effect/decal/cleanable/dirt,
/obj/machinery/airalarm/syndicate{
	dir = 4;
	pixel_x = -24
	},
/turf/open/floor/plasteel/dark,
/area/ruin/space/syndielistenspace)
"yA" = (
/obj/structure/table,
/obj/machinery/firealarm{
	dir = 8;
	pixel_x = -26
	},
/obj/machinery/microwave,
/obj/effect/turf_decal/tile/neutral{
	dir = 1
	},
/obj/effect/turf_decal/tile/neutral,
/obj/effect/turf_decal/tile/neutral{
	dir = 4
	},
/obj/effect/turf_decal/tile/neutral{
	dir = 8
	},
/turf/open/floor/plasteel/dark,
/area/ruin/space/syndielistenspace)
"yC" = (
/obj/structure/table/reinforced,
/obj/machinery/firealarm{
	dir = 2;
	pixel_y = 24
	},
/obj/effect/decal/cleanable/dirt,
/obj/machinery/computer/libraryconsole/bookmanagement,
/turf/open/floor/plasteel/dark,
/area/ruin/space/syndielistenspace)
"yD" = (
/turf/closed/mineral/random,
/area/awaymission)
"yS" = (
/obj/machinery/atmospherics/components/unary/vent_scrubber/on{
	dir = 1;
	piping_layer = 3;
	pixel_x = 5;
	pixel_y = 5
	},
/turf/open/floor/plasteel/white/corner,
/area/ruin/space/syndielistenspace)
"zl" = (
/obj/effect/decal/cleanable/dirt,
/obj/machinery/atmospherics/components/unary/vent_pump/on,
/obj/effect/turf_decal/tile/neutral{
	dir = 1
	},
/obj/effect/turf_decal/tile/neutral,
/obj/effect/turf_decal/tile/neutral{
	dir = 4
	},
/obj/effect/turf_decal/tile/neutral{
	dir = 8
	},
/turf/open/floor/plasteel/dark,
/area/ruin/space/syndielistenspace)
"Bm" = (
/obj/machinery/door/firedoor,
/obj/effect/decal/cleanable/dirt,
/obj/machinery/atmospherics/pipe/simple/supply/hidden,
/obj/machinery/atmospherics/pipe/simple/scrubbers/hidden{
	piping_layer = 3;
	pixel_x = 5;
	pixel_y = 5
	},
/obj/machinery/door/airlock/hatch{
	name = "Telecommunications";
	req_access_txt = "150"
	},
/obj/effect/turf_decal/tile/neutral{
	dir = 1
	},
/obj/effect/turf_decal/tile/neutral,
/obj/effect/turf_decal/tile/neutral{
	dir = 4
	},
/obj/effect/turf_decal/tile/neutral{
	dir = 8
	},
/turf/open/floor/plasteel/dark,
/area/ruin/space/syndielistenspace)
"Bo" = (
/obj/machinery/airalarm/syndicate{
	pixel_y = 24
	},
/obj/effect/decal/cleanable/dirt,
/obj/machinery/atmospherics/pipe/manifold/supply/hidden{
	dir = 1
	},
/obj/machinery/atmospherics/pipe/simple/scrubbers/hidden{
	dir = 4;
	piping_layer = 3;
	pixel_x = 5;
	pixel_y = 5
	},
/obj/effect/baseturf_helper/asteroid/airless,
/obj/effect/turf_decal/tile/red{
	dir = 1
	},
/obj/effect/turf_decal/tile/red{
	dir = 4
	},
/turf/open/floor/plasteel,
/area/ruin/space/syndielistenspace)
"BG" = (
/obj/structure/sink{
	dir = 4;
	pixel_x = 11
	},
/obj/machinery/iv_drip,
/obj/machinery/light/small,
/obj/machinery/airalarm/syndicate{
	dir = 1;
	pixel_y = -24
	},
/obj/effect/decal/cleanable/dirt,
/obj/machinery/atmospherics/components/unary/vent_pump/on{
	dir = 1
	},
/turf/open/floor/plasteel/white/side{
	dir = 6
	},
/area/ruin/space/syndielistenspace)
"CT" = (
/obj/machinery/atmospherics/pipe/simple/supply/hidden,
/obj/effect/decal/cleanable/dirt,
/obj/structure/cable{
	icon_state = "2-8"
	},
/turf/open/floor/plating,
/area/ruin/space/syndielistenspace)
"Ds" = (
/obj/effect/turf_decal/stripes/line{
	dir = 6
	},
/obj/effect/decal/cleanable/dirt,
/obj/effect/decal/cleanable/dirt,
/obj/effect/decal/cleanable/dirt,
/obj/machinery/power/smes/magical,
/obj/structure/cable{
	icon_state = "0-4"
	},
/turf/open/floor/plating,
/area/ruin/space/syndielistenspace)
"DI" = (
/obj/machinery/atmospherics/components/unary/vent_pump/on{
	dir = 1
	},
/obj/machinery/atmospherics/pipe/simple/scrubbers/hidden{
	dir = 5;
	piping_layer = 3;
	pixel_x = 5;
	pixel_y = 5
	},
/turf/open/floor/plasteel/grimy,
/area/ruin/space/syndielistenspace)
"DW" = (
/obj/structure/rack{
	dir = 8
	},
/obj/item/clothing/mask/gas{
	pixel_x = -3;
	pixel_y = 3
	},
/obj/effect/turf_decal/stripes/line,
/obj/item/clothing/mask/gas,
/turf/open/floor/mineral/plastitanium/red,
/area/ruin/space/syndielistenspace)
"EZ" = (
/obj/machinery/door/firedoor,
/obj/machinery/atmospherics/pipe/simple/supply/hidden,
/obj/machinery/atmospherics/pipe/simple/scrubbers/hidden{
	piping_layer = 3;
	pixel_x = 5;
	pixel_y = 5
	},
/obj/machinery/door/airlock/hatch{
	name = "E.V.A. Equipment";
	req_access_txt = "150"
	},
/obj/effect/turf_decal/tile/neutral{
	dir = 1
	},
/obj/effect/turf_decal/tile/neutral,
/obj/effect/turf_decal/tile/neutral{
	dir = 4
	},
/obj/effect/turf_decal/tile/neutral{
	dir = 8
	},
/turf/open/floor/plasteel/dark,
/area/ruin/space/syndielistenspace)
"GN" = (
/turf/closed/wall/r_wall,
/area/ruin/space/syndielistenspace)
"Hl" = (
/obj/effect/turf_decal/stripes/red/corner,
/obj/machinery/light/small{
	dir = 4
	},
/obj/machinery/airalarm/syndicate{
	dir = 8;
	pixel_x = 24
	},
/obj/effect/decal/cleanable/dirt,
/obj/machinery/atmospherics/pipe/simple/supply/hidden,
/obj/machinery/atmospherics/pipe/manifold/scrubbers/hidden{
	dir = 4;
	piping_layer = 3;
	pixel_x = 5;
	pixel_y = 5
	},
/turf/open/floor/plasteel,
/area/ruin/space/syndielistenspace)
"HF" = (
/obj/structure/curtain,
/obj/machinery/shower{
	pixel_y = 14
	},
/obj/machinery/light/small,
/obj/item/soap,
/obj/effect/decal/cleanable/dirt,
/turf/open/floor/plasteel/showroomfloor,
/area/ruin/space/syndielistenspace)
"HX" = (
/obj/structure/filingcabinet,
/obj/item/paper/fluff/ruins/listeningstation/reports/april,
/obj/item/paper/fluff/ruins/listeningstation/reports/may,
/obj/item/paper/fluff/ruins/listeningstation/reports/june,
/obj/item/paper/fluff/ruins/listeningstation/reports/july,
/obj/item/paper/fluff/ruins/listeningstation/reports/august,
/obj/item/paper/fluff/ruins/listeningstation/reports/september,
/obj/item/paper/fluff/ruins/listeningstation/reports/october,
/obj/item/paper/fluff/ruins/listeningstation/receipt,
/obj/effect/decal/cleanable/dirt,
/obj/item/paper/fluff/ruins/listeningstation/odd_report,
/turf/open/floor/plasteel/dark,
/area/ruin/space/syndielistenspace)
"JD" = (
/obj/effect/turf_decal/bot,
/obj/effect/decal/cleanable/dirt,
/obj/effect/decal/cleanable/dirt,
/obj/structure/cable,
/obj/machinery/power/port_gen/pacman,
/turf/open/floor/plating,
/area/ruin/space/syndielistenspace)
"JN" = (
/obj/machinery/light/small,
/obj/effect/decal/cleanable/dirt,
/obj/structure/closet/emcloset/anchored,
/obj/effect/decal/cleanable/dirt,
/turf/open/floor/plasteel,
/area/ruin/space/syndielistenspace)
"JU" = (
/obj/effect/decal/cleanable/dirt,
/obj/machinery/atmospherics/components/unary/vent_scrubber/on{
	dir = 4;
	piping_layer = 3;
	pixel_x = 5;
	pixel_y = 5
	},
/obj/effect/turf_decal/tile/neutral{
	dir = 1
	},
/obj/effect/turf_decal/tile/neutral,
/obj/effect/turf_decal/tile/neutral{
	dir = 4
	},
/obj/effect/turf_decal/tile/neutral{
	dir = 8
	},
/turf/open/floor/plasteel/dark,
/area/ruin/space/syndielistenspace)
"Kf" = (
/obj/effect/decal/cleanable/dirt,
/obj/machinery/atmospherics/pipe/manifold/supply/hidden{
	dir = 4
	},
/obj/machinery/atmospherics/pipe/manifold/scrubbers/hidden{
	dir = 4;
	piping_layer = 3;
	pixel_x = 5;
	pixel_y = 5
	},
/obj/effect/turf_decal/tile/red{
	dir = 1
	},
/obj/effect/turf_decal/tile/red{
	dir = 4
	},
/turf/open/floor/plasteel,
/area/ruin/space/syndielistenspace)
"Kg" = (
/turf/closed/wall,
/area/ruin/space/syndielistenspace)
"Kn" = (
/obj/structure/closet{
	icon_door = "black";
	name = "wardrobe"
	},
/obj/item/clothing/under/color/black{
	pixel_x = -3;
	pixel_y = 3
	},
/obj/item/clothing/under/color/black{
	pixel_x = 1;
	pixel_y = -1
	},
/obj/item/clothing/head/soft/black{
	pixel_x = -3;
	pixel_y = 3
	},
/obj/item/clothing/head/soft/black{
	pixel_x = 1;
	pixel_y = -1
	},
/obj/item/clothing/gloves/fingerless,
/obj/item/clothing/shoes/sneakers/black{
	pixel_x = -3;
	pixel_y = 3
	},
/obj/item/clothing/shoes/sneakers/black{
	pixel_x = 1;
	pixel_y = -1
	},
/obj/effect/decal/cleanable/dirt,
/obj/item/storage/photo_album,
/obj/machinery/light/small,
/turf/open/floor/plasteel/grimy,
/area/ruin/space/syndielistenspace)
"LZ" = (
/obj/effect/decal/cleanable/dirt,
/obj/effect/decal/cleanable/dirt,
/obj/structure/extinguisher_cabinet{
	pixel_x = -27;
	pixel_y = 1
	},
/obj/effect/turf_decal/tile/neutral{
	dir = 1
	},
/obj/effect/turf_decal/tile/neutral,
/obj/effect/turf_decal/tile/neutral{
	dir = 4
	},
/obj/effect/turf_decal/tile/neutral{
	dir = 8
	},
/obj/machinery/computer/arcade/tetris{
	dir = 4
	},
/turf/open/floor/plasteel/dark,
/area/ruin/space/syndielistenspace)
"Mk" = (
/obj/effect/turf_decal/stripes/red/line{
	dir = 4
	},
/obj/effect/turf_decal/caution/red{
	dir = 8
	},
/obj/machinery/atmospherics/pipe/simple/supply/hidden,
/obj/machinery/atmospherics/pipe/simple/scrubbers/hidden{
	piping_layer = 3;
	pixel_x = 5;
	pixel_y = 5
	},
/turf/open/floor/plasteel,
/area/ruin/space/syndielistenspace)
"NF" = (
/obj/structure/table,
/obj/item/storage/toolbox/syndicate,
/obj/item/flashlight{
	pixel_y = -12
	},
/obj/effect/decal/cleanable/dirt,
/turf/open/floor/plasteel/dark,
/area/ruin/space/syndielistenspace)
"Oa" = (
/obj/structure/chair/office/dark{
	dir = 8
	},
/obj/effect/turf_decal/tile/neutral{
	dir = 1
	},
/obj/effect/turf_decal/tile/neutral,
/obj/effect/turf_decal/tile/neutral{
	dir = 4
	},
/obj/effect/turf_decal/tile/neutral{
	dir = 8
	},
/turf/open/floor/plasteel/dark,
/area/ruin/space/syndielistenspace)
"Ow" = (
/obj/effect/decal/cleanable/dirt,
/turf/open/floor/plasteel,
/area/ruin/space/syndielistenspace)
"Pk" = (
/obj/machinery/atmospherics/pipe/manifold/supply/hidden{
	dir = 1
	},
/obj/machinery/atmospherics/pipe/simple/scrubbers/hidden{
	dir = 6;
	piping_layer = 3;
	pixel_x = 5;
	pixel_y = 5
	},
/turf/open/floor/plasteel,
/area/ruin/space/syndielistenspace)
"Pr" = (
/obj/machinery/light/small{
	dir = 4
	},
/obj/effect/turf_decal/stripes/corner{
	dir = 8
	},
/obj/machinery/button/door{
	id = "syndie_listeningpost_external";
	name = "External Bolt Control";
	normaldoorcontrol = 1;
	pixel_x = 24;
	req_access_txt = "150";
	specialfunctions = 4
	},
/obj/machinery/atmospherics/pipe/simple/supply/hidden,
/obj/machinery/atmospherics/components/unary/vent_scrubber/on{
	piping_layer = 3;
	pixel_x = 5;
	pixel_y = 5
	},
/obj/effect/turf_decal/tile/neutral{
	dir = 1
	},
/obj/effect/turf_decal/tile/neutral,
/obj/effect/turf_decal/tile/neutral{
	dir = 4
	},
/obj/effect/turf_decal/tile/neutral{
	dir = 8
	},
/turf/open/floor/plasteel/dark,
/area/ruin/space/syndielistenspace)
"Qp" = (
/obj/effect/mapping_helpers/airlock/cyclelink_helper{
	dir = 4
	},
/obj/machinery/door/airlock/external{
	id_tag = "syndie_listeningpost_external";
	req_access_txt = "150"
	},
/turf/open/floor/plating,
/area/ruin/space/syndielistenspace)
"RF" = (
/obj/machinery/atmospherics/pipe/manifold/supply/hidden{
	dir = 1
	},
/obj/machinery/atmospherics/pipe/simple/scrubbers/hidden{
	dir = 4;
	piping_layer = 3;
	pixel_x = 5;
	pixel_y = 5
	},
/obj/effect/turf_decal/tile/red{
	dir = 1
	},
/obj/effect/turf_decal/tile/red{
	dir = 4
	},
/turf/open/floor/plasteel,
/area/ruin/space/syndielistenspace)
"Sy" = (
/obj/structure/table,
/obj/machinery/computer/security/telescreen/entertainment{
	pixel_x = -30
	},
/obj/item/reagent_containers/food/drinks/beer{
	pixel_x = -4;
	pixel_y = 14
	},
/obj/item/reagent_containers/food/drinks/beer{
	pixel_x = 3;
	pixel_y = 11
	},
/obj/item/storage/fancy/cigarettes/cigpack_syndicate{
	pixel_x = -3
	},
/obj/item/lighter{
	pixel_x = 7;
	pixel_y = -3
	},
/obj/effect/decal/cleanable/dirt,
/obj/effect/turf_decal/tile/neutral{
	dir = 1
	},
/obj/effect/turf_decal/tile/neutral,
/obj/effect/turf_decal/tile/neutral{
	dir = 4
	},
/obj/effect/turf_decal/tile/neutral{
	dir = 8
	},
/turf/open/floor/plasteel/dark,
/area/ruin/space/syndielistenspace)
"SC" = (
/obj/structure/bookcase/random,
/turf/open/floor/plasteel/grimy,
/area/ruin/space/syndielistenspace)
"Tc" = (
/obj/item/bombcore/badmin{
	anchored = 1;
	invisibility = 100
	},
/turf/closed/wall,
/area/ruin/space/syndielistenspace)
"VK" = (
/obj/machinery/telecomms/relay/preset/ruskie{
	use_power = 0
	},
/obj/effect/decal/cleanable/dirt,
/turf/open/floor/plasteel/dark,
/area/ruin/space/syndielistenspace)
"VP" = (
/obj/machinery/computer/camera_advanced{
	dir = 4
	},
/obj/effect/decal/cleanable/dirt,
/obj/machinery/newscaster{
	pixel_y = 32
	},
/obj/item/radio/intercom{
	freerange = 1;
	name = "Syndicate Radio Intercom";
	pixel_x = -30
	},
/turf/open/floor/plasteel/dark,
/area/ruin/space/syndielistenspace)
"VX" = (
/obj/machinery/vending/snack/random{
	extended_inventory = 1
	},
/obj/effect/decal/cleanable/dirt,
/obj/effect/decal/cleanable/dirt,
/obj/structure/sign/poster/contraband/random{
	pixel_x = 32
	},
/obj/effect/turf_decal/tile/red{
	dir = 1
	},
/turf/open/floor/plasteel,
/area/ruin/space/syndielistenspace)
"YD" = (
/obj/machinery/light/small{
	dir = 8
	},
/obj/structure/closet/crate,
/obj/item/stack/sheet/metal/twenty,
/obj/item/stack/sheet/glass{
	amount = 10
	},
/obj/item/stack/rods/ten,
/obj/effect/turf_decal/stripes/line,
/obj/effect/decal/cleanable/dirt,
/obj/item/storage/box/lights/bulbs,
/obj/item/stock_parts/cell/high/plus,
/obj/structure/cable{
	icon_state = "1-2"
	},
/obj/item/stack/sheet/mineral/plasma{
	amount = 20
	},
/obj/item/wrench,
/turf/open/floor/plating,
/area/ruin/space/syndielistenspace)
"YY" = (
/obj/effect/turf_decal/stripes/line{
	dir = 4
	},
/obj/effect/decal/cleanable/dirt,
/obj/machinery/atmospherics/components/unary/vent_pump/on,
/obj/effect/turf_decal/tile/neutral{
	dir = 1
	},
/obj/effect/turf_decal/tile/neutral,
/obj/effect/turf_decal/tile/neutral{
	dir = 4
	},
/obj/effect/turf_decal/tile/neutral{
	dir = 8
	},
/turf/open/floor/plasteel/dark,
/area/ruin/space/syndielistenspace)
"ZG" = (
/obj/effect/decal/cleanable/dirt,
/obj/machinery/computer/med_data/syndie{
	dir = 4;
	req_one_access = null
	},
/turf/open/floor/plasteel/dark,
/area/ruin/space/syndielistenspace)

(1,1,1) = {"
ae
ae
ae
ae
ae
ae
ae
ae
ae
ae
ae
ae
ae
ae
ae
ae
ae
ae
ae
ae
"}
(2,1,1) = {"
ae
ae
yD
yD
yD
yD
yD
yD
yD
yD
yD
ae
yD
yD
yD
yD
yD
ae
ae
ae
"}
(3,1,1) = {"
ae
ae
yD
yD
yD
yD
yD
yD
yD
yD
yD
yD
yD
yD
yD
yD
yD
yD
ae
ae
"}
(4,1,1) = {"
ae
yD
yD
yD
yD
yD
yD
yD
yD
yD
yD
yD
yD
yD
yD
yD
yD
yD
yD
ae
"}
(5,1,1) = {"
ae
yD
yD
yD
yD
yD
yD
yD
yD
yD
yD
yD
yD
yD
yD
yD
yD
yD
yD
ae
"}
(6,1,1) = {"
ae
yD
yD
yD
yD
Kg
Kg
Kg
Kg
Kg
Kg
Kg
Kg
yD
yD
yD
yD
yD
yD
ae
"}
(7,1,1) = {"
yD
yD
yD
yD
yD
Kg
HF
Kg
LZ
yA
Sy
tg
Kg
Kg
Kg
yD
yD
yD
yD
ae
"}
(8,1,1) = {"
yD
yD
yD
yD
yD
Kg
ag
wW
Ow
ty
xw
lW
Kg
SC
Kg
Kg
yD
yD
yD
ae
"}
(9,1,1) = {"
yD
yD
yD
yD
Kg
Kg
Kg
Kg
kO
Pk
Hl
Mk
vj
DI
Kn
Kg
yD
yD
yD
ae
"}
(10,1,1) = {"
yD
yD
yD
Kg
Kg
VP
ZG
Kg
Kg
vH
Kg
yi
Kg
pa
qH
Kg
yD
yD
yD
ae
"}
(11,1,1) = {"
yD
yD
yD
Kg
ii
Oa
JU
HX
Kg
gu
Kg
Kg
Kg
Kg
Kg
Kg
Kg
yD
yD
ae
"}
(12,1,1) = {"
yD
yD
yD
Kg
yC
zl
mU
bX
Bm
hs
JN
Kg
Ds
bn
YD
JD
Kg
yD
yD
ae
"}
(13,1,1) = {"
yD
yD
yD
Kg
Kg
VK
ab
xh
Kg
Bo
fs
vP
CT
vJ
fW
qp
Kg
yD
yD
ae
"}
(14,1,1) = {"
yD
yD
yD
yD
Kg
Kg
Kg
Kg
Tc
RF
kE
Kg
Kg
Kg
Kg
Kg
Kg
yD
yD
ae
"}
(15,1,1) = {"
yD
yD
yD
Kg
Kg
NF
yy
bk
Kg
gN
yS
ve
mZ
kd
Kg
yD
yD
yD
yD
ae
"}
(16,1,1) = {"
yD
yD
yD
Kg
DW
YY
Pr
lp
EZ
Kf
ia
ff
hg
BG
Kg
yD
yD
yD
yD
ae
"}
(17,1,1) = {"
ae
yD
yD
Kg
Kg
Qp
Kg
ui
Kg
VX
rJ
Kg
fm
Kg
Kg
yD
yD
yD
yD
ae
"}
(18,1,1) = {"
ae
yD
yD
yD
GN
pV
GN
rr
GN
Kg
Kg
Kg
Kg
Kg
yD
yD
yD
yD
yD
ae
"}
(19,1,1) = {"
ae
yD
yD
yD
GN
te
GN
ax
yD
yD
yD
yD
yD
yD
yD
yD
yD
yD
ae
ae
"}
(20,1,1) = {"
ae
ae
ae
ae
ae
mh
ae
ae
ae
ae
ae
ae
ae
ae
ae
yD
yD
ae
ae
ae
"}
