"a" = (/turf/closed/wall/mineral/titanium,/area/shuttle/custom{name = "AI Access Shuttle"})
"b" = (/obj/structure/chair/comfy/shuttle{dir = 1},/turf/open/floor/mineral/titanium/white,/area/shuttle/custom{name = "AI Access Shuttle"})
"k" = (/obj/structure/chair/comfy/shuttle,/turf/open/floor/mineral/titanium/blue,/area/shuttle/custom{name = "AI Access Shuttle"})
"m" = (/obj/structure/chair/comfy/shuttle,/turf/open/floor/mineral/titanium/white,/area/shuttle/custom{name = "AI Access Shuttle"})
"p" = (/obj/machinery/door/airlock/titanium/glass,/obj/docking_port/mobile{dwidth = 3; height = 5; id = "smol"; name = "AI Satellite Access Shuttle"; width = 7},/turf/open/floor/mineral/titanium,/area/shuttle/custom{name = "AI Access Shuttle"})
"u" = (/obj/machinery/door/airlock/titanium/glass,/turf/open/floor/mineral/titanium,/area/shuttle/custom{name = "AI Access Shuttle"})
"w" = (/obj/structure/closet/crate{anchored = 1},/obj/item/storage/firstaid/regular,/turf/open/floor/mineral/titanium/white,/area/shuttle/custom{name = "AI Access Shuttle"})
"C" = (/obj/machinery/computer/shuttle{dir = 8; name = "AI Access Shuttle Console"; possible_destinations = "smol"; shuttleId = "smol"},/turf/open/floor/mineral/titanium/blue,/area/shuttle/custom{name = "AI Access Shuttle"})
"D" = (/turf/open/floor/mineral/titanium/white,/area/shuttle/custom{name = "AI Access Shuttle"})
"E" = (/turf/open/floor/mineral/titanium/blue,/area/shuttle/custom{name = "AI Access Shuttle"})
"F" = (/obj/structure/closet/emcloset/anchored,/obj/structure/closet/emcloset/anchored,/turf/open/floor/mineral/titanium/white,/area/shuttle/custom{name = "AI Access Shuttle"})
"J" = (/obj/effect/spawner/structure/window/shuttle,/turf/open/floor/plating,/area/shuttle/custom{name = "AI Access Shuttle"})
"K" = (/obj/structure/shuttle/engine/heater{dir = 8},/obj/structure/window/reinforced{dir = 4},/obj/structure/window/reinforced{dir = 1},/obj/structure/window/reinforced,/turf/open/floor/plating/airless,/area/shuttle/custom{name = "AI Access Shuttle"})
"R" = (/obj/structure/chair/comfy/shuttle{dir = 1},/turf/open/floor/mineral/titanium/blue,/area/shuttle/custom{name = "AI Access Shuttle"})
"Y" = (/obj/structure/shuttle/engine/propulsion/burst{dir = 8},/turf/open/floor/plating/airless,/area/shuttle/custom{name = "AI Access Shuttle"})

(1,1,1) = {"
aaJuJaa
aFmEkEa
YKDEECJ
awbEREa
aaJpJaa
"}
