//MAP CONVERTED BY dmm2tgm.py THIS HEADER COMMENT PREVENTS RECONVERSION, DO NOT REMOVE
"a" = (
/turf/closed/wall/mineral/titanium,
/area/space)
"h" = (
/obj/structure/table,
/obj/item/folder/red,
/obj/item/restraints/handcuffs,
/turf/open/floor/mineral/plastitanium/red,
/area/space)
"j" = (
/turf/open/floor/mineral/plastitanium/red,
/area/space)
"l" = (
/obj/machinery/button/flasher{
	id = "gulagshuttleflasher";
	name = "Flash Control";
	pixel_y = -26;
	req_access_txt = "1"
	},
/obj/machinery/light,
/turf/open/floor/mineral/plastitanium/red,
/area/space)
"w" = (
/obj/machinery/door/airlock/titanium{
	name = "Labor Shuttle Airlock";
	req_access_txt = "2"
	},
/turf/open/floor/mineral/plastitanium/red,
/area/space)
"y" = (
/obj/machinery/door/airlock/titanium{
	id_tag = "prisonshuttle";
	name = "Labor Shuttle Airlock";
	req_access_txt = "2"
	},
/obj/docking_port/mobile{
	dir = 8;
	dwidth = 2;
	height = 5;
	id = "smolperma";
	width = 8
	},
/turf/open/floor/plating,
/area/space)
"z" = (
/obj/effect/spawner/structure/window/shuttle,
/turf/open/floor/plating,
/area/space)
"D" = (
/obj/structure/shuttle/engine/propulsion,
/turf/open/floor/plating/airless,
/area/space)
"E" = (
/obj/structure/shuttle/engine/heater,
/obj/structure/window/reinforced{
	dir = 1;
	layer = 2.9
	},
/turf/open/floor/plating/airless,
/area/space)
"G" = (
/obj/machinery/flasher{
	id = "gulagshuttleflasher";
	pixel_x = 25;
	pixel_y = -5
	},
/obj/structure/chair/comfy/shuttle{
	dir = 8
	},
/turf/open/floor/mineral/titanium,
/area/space)
"H" = (
/obj/effect/spawner/structure/window/shuttle,
/turf/open/floor/plating/airless,
/area/space)
"O" = (
/obj/structure/closet/crate{
	anchored = 1
	},
/turf/open/floor/mineral/titanium,
/area/space)
"P" = (
/obj/machinery/door/airlock/titanium{
	name = "Labor Shuttle Airlock";
	req_access_txt = "2"
	},
/turf/open/floor/plating,
/area/space)
"Q" = (
/obj/machinery/light{
	dir = 1
	},
/turf/open/floor/mineral/titanium,
/area/space)
"R" = (
/obj/structure/chair/office/dark{
	dir = 1
	},
/turf/open/floor/mineral/plastitanium/red,
/area/space)
"V" = (
/turf/open/floor/mineral/titanium,
/area/space)
"Z" = (
/obj/structure/reagent_dispensers/peppertank{
	pixel_x = -31
	},
/obj/machinery/computer/shuttle{
	dir = 4;
	name = "Perma Prison Shuttle Console";
	possible_destinations = "smolperma";
	shuttleId = "smolperma"
	},
/turf/open/floor/mineral/plastitanium/red,
/area/space)

(1,1,1) = {"
a
a
a
a
H
a
a
a
"}
(2,1,1) = {"
z
Z
j
w
V
O
E
D
"}
(3,1,1) = {"
z
R
l
a
Q
V
E
D
"}
(4,1,1) = {"
z
h
j
z
G
V
E
D
"}
(5,1,1) = {"
a
a
P
a
a
y
a
a
"}
