//MAP CONVERTED BY dmm2tgm.py THIS HEADER COMMENT PREVENTS RECONVERSION, DO NOT REMOVE
"aa" = (
/obj/structure/window/reinforced/tinted{
	dir = 8
	},
/obj/structure/window/reinforced/tinted,
/turf/open/indestructible/hoteltile,
/area/hilbertshotel)
"br" = (
/obj/machinery/atmospherics/components/unary/vent_pump/hilbertshotel{
	dir = 4
	},
/turf/open/floor/carpet,
/area/hilbertshotel)
"bx" = (
/obj/structure/mineral_door/wood,
/turf/open/indestructible/hotelwood,
/area/hilbertshotel)
"bP" = (
/obj/machinery/atmospherics/pipe/simple/scrubbers/hidden{
	dir = 4;
	piping_layer = 3;
	pixel_x = 5;
	pixel_y = 5
	},
/turf/open/indestructible/hotelwood,
/area/hilbertshotel)
"dl" = (
/obj/structure/table/reinforced,
/obj/item/reagent_containers/food/drinks/bottle/champagne,
/turf/open/floor/plasteel/cafeteria,
/area/hilbertshotel)
"dH" = (
/obj/structure/toilet{
	dir = 8
	},
/obj/structure/window/reinforced/tinted{
	dir = 1
	},
/obj/structure/window/reinforced/tinted{
	dir = 8
	},
/obj/machinery/atmospherics/pipe/simple/scrubbers/hidden{
	piping_layer = 3;
	pixel_x = 5;
	pixel_y = 5
	},
/turf/open/indestructible/hoteltile,
/area/hilbertshotel)
"dN" = (
/obj/structure/table/reinforced,
/obj/item/soap/deluxe,
/obj/machinery/light/small{
	dir = 8
	},
/turf/open/indestructible/hoteltile,
/area/hilbertshotel)
"eN" = (
/obj/machinery/atmospherics/pipe/simple/supply/hidden{
	dir = 4
	},
/obj/machinery/atmospherics/pipe/simple/scrubbers/hidden{
	dir = 4;
	piping_layer = 3;
	pixel_x = 5;
	pixel_y = 5
	},
/turf/closed/indestructible/hotelwall,
/area/hilbertshotel)
"fv" = (
/obj/structure/lattice,
/obj/machinery/atmospherics/components/unary/outlet_injector/hilbertshotel/layer3,
/turf/open/space/bluespace,
/area/hilbertshotel)
"fF" = (
/obj/machinery/atmospherics/pipe/manifold/supply/hidden{
	dir = 4
	},
/obj/machinery/atmospherics/pipe/manifold/scrubbers/hidden{
	dir = 4;
	piping_layer = 3;
	pixel_x = 5;
	pixel_y = 5
	},
/turf/closed/indestructible/hotelwall,
/area/hilbertshotel)
"hk" = (
/obj/machinery/atmospherics/components/unary/vent_scrubber/hilbertshotel/layer3{
	dir = 8
	},
/turf/open/floor/carpet,
/area/hilbertshotel)
"hn" = (
/obj/item/toy/plush/beeplushie,
/obj/structure/table/wood/fancy,
/turf/open/indestructible/hotelwood,
/area/hilbertshotel)
"hz" = (
/obj/structure/mineral_door/paperframe,
/obj/machinery/atmospherics/pipe/simple/supply/hidden{
	dir = 4
	},
/obj/machinery/atmospherics/pipe/simple/scrubbers/hidden{
	dir = 4;
	piping_layer = 3;
	pixel_x = 5;
	pixel_y = 5
	},
/turf/open/indestructible/hotelwood,
/area/hilbertshotel)
"hK" = (
/obj/structure/chair/stool/bar,
/turf/open/indestructible/hotelwood,
/area/hilbertshotel)
"iq" = (
/obj/structure/table/reinforced,
/obj/effect/spawner/lootdrop/three_course_meal,
/turf/open/floor/plasteel/cafeteria,
/area/hilbertshotel)
"iH" = (
/obj/machinery/atmospherics/pipe/simple/supply/hidden{
	dir = 1
	},
/obj/machinery/atmospherics/pipe/simple/scrubbers/hidden{
	piping_layer = 3;
	pixel_x = 5;
	pixel_y = 5
	},
/turf/open/floor/carpet,
/area/hilbertshotel)
"jS" = (
/obj/structure/mirror{
	pixel_x = -32
	},
/obj/structure/sink{
	dir = 8;
	pixel_x = -12;
	pixel_y = 2
	},
/turf/open/indestructible/hoteltile,
/area/hilbertshotel)
"ke" = (
/obj/machinery/light_switch{
	pixel_x = -32
	},
/turf/open/indestructible/hotelwood,
/area/hilbertshotel)
"kU" = (
/obj/machinery/telecomms/relay/preset/auto,
/turf/open/floor/catwalk_floor,
/area/hilbertshotel)
"kX" = (
/obj/structure/table/reinforced,
/turf/open/floor/plasteel/cafeteria,
/area/hilbertshotel)
"nD" = (
/obj/machinery/atmospherics/pipe/simple/scrubbers/hidden{
	dir = 5;
	piping_layer = 3;
	pixel_x = 5;
	pixel_y = 5
	},
/obj/structure/lattice,
/turf/closed/indestructible/hotelwall,
/area/hilbertshotel)
"nK" = (
/obj/machinery/atmospherics/components/unary/vent_pump/hilbertshotel{
	dir = 4
	},
/obj/machinery/atmospherics/pipe/simple/scrubbers/hidden{
	dir = 4;
	piping_layer = 3;
	pixel_x = 5;
	pixel_y = 5
	},
/turf/open/indestructible/hotelwood,
/area/hilbertshotel)
"ot" = (
/obj/machinery/atmospherics/pipe/simple/scrubbers/hidden{
	dir = 4;
	piping_layer = 3;
	pixel_x = 5;
	pixel_y = 5
	},
/obj/structure/lattice,
/turf/closed/indestructible/hotelwall,
/area/hilbertshotel)
"qH" = (
/turf/open/floor/plasteel/stairs/left,
/area/hilbertshotel)
"re" = (
/obj/structure/table/reinforced,
/obj/item/reagent_containers/food/drinks/drinkingglass,
/obj/item/reagent_containers/food/drinks/drinkingglass{
	pixel_x = -2;
	pixel_y = 4
	},
/obj/item/reagent_containers/food/drinks/drinkingglass{
	pixel_y = 7
	},
/obj/item/reagent_containers/food/drinks/drinkingglass{
	pixel_x = 5;
	pixel_y = 4
	},
/obj/item/reagent_containers/food/drinks/drinkingglass{
	pixel_x = -5;
	pixel_y = 5
	},
/turf/open/floor/plasteel/cafeteria,
/area/hilbertshotel)
"su" = (
/obj/structure/dresser,
/obj/machinery/light/small{
	dir = 4
	},
/turf/open/indestructible/hotelwood,
/area/hilbertshotel)
"uU" = (
/obj/machinery/shower{
	dir = 8
	},
/turf/open/indestructible/hoteltile,
/area/hilbertshotel)
"wf" = (
/turf/open/indestructible/hoteltile,
/area/hilbertshotel)
"wC" = (
/obj/structure/lattice,
/turf/closed/indestructible/hotelwall,
/area/hilbertshotel)
"wT" = (
/obj/machinery/light/small{
	dir = 1
	},
/obj/machinery/atmospherics/pipe/simple/supply/hidden{
	dir = 1
	},
/obj/machinery/atmospherics/pipe/simple/scrubbers/hidden{
	piping_layer = 3;
	pixel_x = 5;
	pixel_y = 5
	},
/turf/open/indestructible/hoteltile,
/area/hilbertshotel)
"xG" = (
/obj/structure/table/reinforced,
/obj/machinery/light/small{
	dir = 4
	},
/turf/open/floor/plasteel/cafeteria,
/area/hilbertshotel)
"yh" = (
/obj/machinery/light/small{
	dir = 8
	},
/turf/open/indestructible/hotelwood,
/area/hilbertshotel)
"zo" = (
/obj/machinery/door/window/northleft,
/obj/machinery/airalarm/all_access{
	dir = 4;
	pixel_x = -24
	},
/turf/open/floor/plasteel/cafeteria,
/area/hilbertshotel)
"zr" = (
/obj/machinery/atmospherics/components/unary/vent_scrubber/hilbertshotel/layer3{
	dir = 4
	},
/turf/open/indestructible/hotelwood,
/area/hilbertshotel)
"zD" = (
/obj/machinery/jukebox{
	req_one_access = null
	},
/turf/open/indestructible/hotelwood,
/area/hilbertshotel)
"AZ" = (
/obj/structure/chair/comfy/brown{
	dir = 1
	},
/turf/open/indestructible/hotelwood,
/area/hilbertshotel)
"Ba" = (
/obj/machinery/atmospherics/pipe/manifold/supply/hidden{
	dir = 4
	},
/obj/machinery/atmospherics/pipe/manifold/scrubbers/hidden{
	dir = 8;
	piping_layer = 3;
	pixel_x = 5;
	pixel_y = 5
	},
/turf/open/floor/carpet,
/area/hilbertshotel)
"Bt" = (
/obj/structure/window/reinforced/tinted{
	dir = 8
	},
/obj/structure/window/reinforced/tinted{
	dir = 1
	},
/turf/open/indestructible/hoteltile,
/area/hilbertshotel)
"BG" = (
/obj/structure/sign/painting/library{
	pixel_y = 32
	},
/turf/open/indestructible/hotelwood,
/area/hilbertshotel)
"Ce" = (
/turf/open/floor/plasteel/stairs/medium,
/area/hilbertshotel)
"CN" = (
/turf/open/floor/plasteel/cafeteria,
/area/hilbertshotel)
"CO" = (
/obj/structure/lattice,
/obj/machinery/atmospherics/components/unary/tank/air{
	dir = 8
	},
/turf/open/space/bluespace,
/area/hilbertshotel)
"FR" = (
/obj/item/bikehorn/rubberducky,
/obj/machinery/light/small{
	dir = 4
	},
/turf/open/indestructible/hoteltile,
/area/hilbertshotel)
"GW" = (
/turf/open/space/bluespace,
/area/hilbertshotel)
"HD" = (
/obj/structure/lattice,
/obj/machinery/atmospherics/pipe/manifold/supply/hidden{
	dir = 1
	},
/obj/machinery/meter,
/turf/open/space/bluespace,
/area/hilbertshotel)
"Ii" = (
/obj/machinery/vending/kink,
/turf/open/indestructible/hotelwood,
/area/hilbertshotel)
"Ir" = (
/obj/structure/pole{
	pixel_y = 9
	},
/obj/structure/table/reinforced,
/turf/open/indestructible/hotelwood,
/area/hilbertshotel)
"IT" = (
/turf/closed/indestructible/hoteldoor,
/area/hilbertshotel)
"Js" = (
/obj/machinery/smartfridge/food,
/turf/open/floor/plasteel/cafeteria,
/area/hilbertshotel)
"JK" = (
/obj/structure/fireplace{
	pixel_y = -6
	},
/obj/machinery/atmospherics/pipe/simple/supply/hidden{
	dir = 1
	},
/obj/machinery/atmospherics/pipe/simple/scrubbers/hidden{
	piping_layer = 3;
	pixel_x = 5;
	pixel_y = 5
	},
/turf/open/indestructible/hotelwood,
/area/hilbertshotel)
"KD" = (
/obj/machinery/light/small,
/obj/effect/landmark/xmastree/hilbert,
/obj/machinery/atmospherics/pipe/simple/supply/hidden{
	dir = 1
	},
/obj/machinery/atmospherics/pipe/simple/scrubbers/hidden{
	piping_layer = 3;
	pixel_x = 5;
	pixel_y = 5
	},
/turf/open/indestructible/hotelwood,
/area/hilbertshotel)
"Ld" = (
/obj/machinery/light/small{
	dir = 1
	},
/turf/open/indestructible/hotelwood,
/area/hilbertshotel)
"LT" = (
/obj/structure/closet/crate/bin,
/obj/machinery/light/small{
	dir = 4
	},
/obj/machinery/atmospherics/pipe/simple/supply/hidden{
	dir = 4
	},
/obj/machinery/atmospherics/pipe/simple/scrubbers/hidden{
	dir = 4;
	piping_layer = 3;
	pixel_x = 5;
	pixel_y = 5
	},
/turf/open/indestructible/hotelwood,
/area/hilbertshotel)
"LX" = (
/obj/structure/window/reinforced/tinted{
	dir = 8
	},
/turf/open/indestructible/hoteltile,
/area/hilbertshotel)
"Ml" = (
/obj/machinery/atmospherics/pipe/simple/supply/hidden{
	dir = 1
	},
/obj/machinery/atmospherics/pipe/simple/scrubbers/hidden{
	dir = 10;
	piping_layer = 3;
	pixel_x = 5;
	pixel_y = 5
	},
/obj/structure/lattice,
/turf/closed/indestructible/hotelwall,
/area/hilbertshotel)
"Mt" = (
/obj/structure/table/reinforced,
/turf/open/indestructible/hotelwood,
/area/hilbertshotel)
"MA" = (
/obj/structure/table/wood/fancy,
/turf/open/indestructible/hotelwood,
/area/hilbertshotel)
"MZ" = (
/turf/open/indestructible/hotelwood,
/area/hilbertshotel)
"NV" = (
/obj/structure/table/reinforced,
/obj/machinery/microwave,
/turf/open/floor/plasteel/cafeteria,
/area/hilbertshotel)
"Ow" = (
/obj/machinery/light/small{
	dir = 8
	},
/turf/open/floor/plasteel/cafeteria,
/area/hilbertshotel)
"QV" = (
/obj/structure/bed/double,
/obj/item/bedsheet/random/double,
/turf/open/indestructible/hotelwood,
/area/hilbertshotel)
"Rt" = (
/obj/machinery/light/small{
	dir = 4
	},
/turf/open/indestructible/hotelwood,
/area/hilbertshotel)
"RP" = (
/obj/machinery/atmospherics/components/unary/vent_scrubber/hilbertshotel/layer3{
	dir = 1
	},
/turf/open/indestructible/hoteltile,
/area/hilbertshotel)
"Si" = (
/turf/closed/indestructible/hotelwall,
/area/hilbertshotel)
"Tt" = (
/turf/open/floor/plasteel/stairs/right,
/area/hilbertshotel)
"TB" = (
/obj/structure/lattice,
/obj/machinery/atmospherics/components/unary/tank/air{
	dir = 4
	},
/turf/open/space/bluespace,
/area/hilbertshotel)
"Uc" = (
/obj/item/kirbyplants/random,
/turf/open/indestructible/hotelwood,
/area/hilbertshotel)
"Um" = (
/obj/item/candle/infinite,
/obj/structure/table/wood/fancy,
/turf/open/indestructible/hotelwood,
/area/hilbertshotel)
"Us" = (
/obj/structure/closet/cabinet{
	anchored = 1
	},
/turf/open/indestructible/hotelwood,
/area/hilbertshotel)
"VT" = (
/obj/structure/table/reinforced,
/obj/structure/sink/kitchen,
/obj/machinery/light/small,
/turf/open/floor/plasteel/cafeteria,
/area/hilbertshotel)
"WK" = (
/obj/structure/table/reinforced,
/obj/item/soap/deluxe,
/turf/open/indestructible/hoteltile,
/area/hilbertshotel)
"WM" = (
/obj/structure/curtain,
/turf/open/indestructible/hoteltile,
/area/hilbertshotel)
"Yl" = (
/obj/machinery/atmospherics/components/unary/vent_pump/hilbertshotel{
	dir = 1
	},
/obj/machinery/atmospherics/pipe/simple/scrubbers/hidden{
	piping_layer = 3;
	pixel_x = 5;
	pixel_y = 5
	},
/turf/open/indestructible/hoteltile,
/area/hilbertshotel)
"YD" = (
/obj/machinery/light/small,
/turf/open/indestructible/hoteltile,
/area/hilbertshotel)
"YR" = (
/obj/structure/table/wood/fancy,
/obj/item/stack/spacecash/c100,
/turf/open/indestructible/hotelwood,
/area/hilbertshotel)
"Zx" = (
/turf/open/floor/carpet,
/area/hilbertshotel)

(1,1,1) = {"
GW
GW
GW
GW
GW
GW
GW
GW
GW
GW
GW
GW
GW
GW
GW
GW
"}
(2,1,1) = {"
GW
GW
Si
Si
Si
Si
Si
IT
Si
Si
Si
Si
Si
Si
Si
GW
"}
(3,1,1) = {"
GW
GW
Si
Uc
yh
MZ
MZ
MZ
yh
MZ
zo
Ow
NV
kX
Si
GW
"}
(4,1,1) = {"
GW
GW
Si
Mt
qH
MZ
YR
AZ
zr
hK
kX
CN
CN
kX
Si
GW
"}
(5,1,1) = {"
GW
GW
Si
Ir
Ce
MZ
Um
AZ
bP
hK
iq
CN
CN
VT
Si
GW
"}
(6,1,1) = {"
GW
GW
Si
Mt
Tt
MZ
MA
AZ
nK
hK
re
CN
CN
kX
Si
GW
"}
(7,1,1) = {"
GW
GW
Si
zD
Rt
MZ
MZ
MZ
LT
Uc
dl
xG
Js
kX
Si
GW
"}
(8,1,1) = {"
GW
kU
Si
Si
Si
bx
Si
Si
eN
Si
Si
Si
Si
Si
Si
GW
"}
(9,1,1) = {"
GW
fv
nD
Uc
yh
MZ
ke
MZ
hz
wf
jS
dN
jS
WK
Si
GW
"}
(10,1,1) = {"
GW
TB
ot
BG
Zx
br
Zx
MZ
eN
wf
wf
wf
wf
wf
Si
GW
"}
(11,1,1) = {"
GW
HD
Ml
JK
iH
Ba
iH
KD
fF
wT
Yl
dH
RP
YD
Si
GW
"}
(12,1,1) = {"
GW
CO
wC
BG
Zx
hk
Zx
MZ
Si
WM
Bt
LX
aa
WM
Si
GW
"}
(13,1,1) = {"
GW
GW
Si
Ld
MZ
MZ
MZ
MZ
Si
wf
wf
wf
wf
wf
Si
GW
"}
(14,1,1) = {"
GW
GW
Si
Ii
Us
QV
su
hn
Si
wf
uU
FR
uU
wf
Si
GW
"}
(15,1,1) = {"
GW
GW
Si
Si
Si
Si
Si
Si
Si
Si
Si
Si
Si
Si
Si
GW
"}
(16,1,1) = {"
GW
GW
GW
GW
GW
GW
GW
GW
GW
GW
GW
GW
GW
GW
GW
GW
"}
